---------------------------------------------------------------------------------------------------------------------------------------------------------------------------------------------------------
---------------------------------------------------------------------------------------------------------------------------------------------------------------------------------------------------------
---------------------------------------------------------------------------------------------------------------------------------------------------------------------------------------------------------
---------------------------------------------------------------------------------------------------------------------------------------------------------------------------------------------------------
----------------------------------------------------------------------------------E----------------------------------------------------------------------------------------------------------------------
----------------------?---------------------------------------------------------BBBBBBBB---BBB?--------------?-----------BBB----B??B--------------------------------------------------------BB----------v
-------------------------------------------------------------------------------------------------------------------------------------------------------------------------------------------BBB----------f
-------------------------------------------------------------------------------E----------------------------------------------------------------------------------------------------------BBBB----------f
----------------------------------------------------------------B------------------------------------------------------------------------------------------------------------------------BBBBB----------f
----------------?---B?BMB---------------------T----------T-------------------BMB--------------B-----BB----?--?--?-----B----------BB------B--B----------BB--B------------BB?B------------BBBBBB----------f
--------------------------------------T-------|----------|------------------------------------------------------------------------------BB--BB--------BBB--BB--------------------------BBBBBBB----------f
----------------------------T---------|-------|----------|-----------------------------------------------------------------------------BBB--BBB------BBBB--BBB-----T---------------T--BBBBBBBB----------f
m--------------------E------|---------|--E----|------E-E-|-------------------------------------E-E--------E-----------------EE-E-E----BBBB--BBBB----BBBBB--BBBB----|----------EE---|-BBBBBBBBB----------B
BBBBBBBBBBBBBBBBBBBBBBBBBBBBBBBBBBBBBBBBBBBBBBBBBBBBBBBBBBBBBBBBBBBBB--BBBBBBBBBBBBBBB---BBBBBBBBBBBBBBBBBBBBBBBBBBBBBBBBBBBBBBBBBBBBBBBBBBBBBBBBBBBBBBBB--BBBBBBBBBBBBBBBBBBBBBBBBBBBBBBBBBBBBBBBBBBBBBB
