----------------?---------------------------------------------------M------------------------------------------------------------------------------------------------------------------------------------
------------------------o----------------------?-------------------------------------------------------------------------------o-------------------B-----------------------------------------------------
---------------------------------------------------------------------------------------------------------------------------------------------------------------------------------------------------------
-----------------------------------------------------------------------------------------------------o-------M----------------------------------------------------------o--------------------------------
----------------------------------------------------------------------------X-------------------BBBBM--------------------------------------------???????-------------------------------------X-----------
---------------X---------------------------------------------------------------------------------o-------------------------------------------------------------------------------------------------------
---------------------------------------------------------------------------------------------------------------------------------------------------------------------------------------------------------
---------------------------------------------------X-------------------------------------------------------------------------------------------------------------------------------------------?-------v-
-----------------------------????????-------------XX----------------------------------------?----------------------------------------------------------------------------------------------------------f-
-------------------------------------------------XXX------------------------------------X----------------------------------------------------------o--------------------X------------------------------f-
---------------------------------------------T--XXXX-----------------------------------XX--------------------------B------------------------------------------------------?????------------------------f-
---------------------------------------------|-XXXXX----------------------------------XXX-------------T-------------------------?--------------------------X-------------------------------------------f-
---------------------------------------------|XXXXXX-----------------M---------------XXXX-------------|-------------------------------T---------------------?-------------------------X----------------f-
--------o------------------------------------|XXXXXX--------------XXXX------M-------XXXXX------------?|-------------------------------|--T--------------------------------------------XX---------------f-
m-------------------------------------------X|XXXXXX-------------------------------XXXXXX-------------|-----------------E-------------|--|--------------------------------------------XXX--------------X-
XXXXXXXXXXXX-------XoXXXBBBBBBBBXXXXXXXXXX-XX|XXXXXXXXXXXXXXXXXXXXXXXXXXXXXXXXX---XXXXXXXXXXXXXXXXXXXX|XXXXXXXXXXXXXXXXXXXXXXXXXXXXXXX|XX|XXXXXXXXXXXXXXXXXXXXXXXXXXXXXXXXXXXXXXXXXXXXXXXXXXXXXXXXXXXXXX-
