---------------------------------------------------------------------------------------------------------------------------------------------------------------------------------------------------------
---------------------------------------------------------------------------------------------------------------------------------------------------------------------------------------------------------
---------------------------M--------BM-----o-----------------B-------------------------------------------------------------------------------------------------------------------------------------------
------B----------------------------o----------------o------------BB----------------E-----------------------------------------------------MB--o-----------B------?------o---------------------------------
----o----------o----------------B-------------------------------------------------------------------------------------o----------------------------oBB------------------------------------M--------------
------------------------------------------------MMM----?--------------------B------B----B-------------------oB-----o-------------------------------------------------------?B-B----BMB---Eo--B-----------
----------------BBo-----------?----------------------------------------------BB--------o-----------------o-------------BX--BB-B-------------------------XM---------XB-BXB--------------------------------
-------------------o----------oM-----------M---------------------------------------------------------------------------------------------XMM-------?X--------------------------------------------------v-
----------------------------------------------------------------?-----?-------o-----------BX--------------B---------------------o--------o----BMo--------------------------------------------BB--------f-
--------------------------------------------BBB----------------------------------------------------------------------------------------------------o-----------------------BB-------B----------------B-f-
-------o-o-----E----------------------o--------X---------o--oo-----?X-----B?B-------o---------M-?-o-o---oo--EMX-----XB-----------------------------------------XBX----?------------------M---oo----M---f-
--------------XMMBBB------M-o??-MM--------B?------ooo-o-----o----o-----------?--------BX-o--oo--oooM------MXM----B-----Bo--B?--o--oo-------------------BB---------BB-------------oo----------o--oo-----f-
---------oo-----------o-----o---o-oo-------o-----T-ooo-----BT---o-----oo-oo----BB--------oB----ooT----o-T-o----o-------oT--o-B-o---o--BB-Boo-----o-BB-------------------oo-oBB----ToBBB---o--o------B--f-
----------------------------------oo----------T--|TT-T------|---T------o-T------------------T--o-|----o-|---------------|---------T--------o-----------o----------------TTo-------|---------o---T------f-
m----------E----------------------T-----------|--|||-|E-----|E--|-----T--|----E-------------|--T-|----T-|-------E-----E-|---------|E------T-----------T-----------------||T-----E-|---------T---|------X-
X---XXXXX--XX-XXXX-XX-XXXXX---XXXX|XXXXXXXX-XX|XX|||X|XX-XX-|XXX|----X|XX|XXXXXXX-XXXXX-XXXX|XX|X|XX-X|-|-XXXXXXXXXXXXXX|--XXXXXXX|XXXXXXX|XXXXXXXXXXX|XXXXXXXXXXXXXXXXX|||XXXXXXX|XXXXXXXXX|-XX|XX---XX-
