---------------------------------------------------------------------------------------------------------------------------------------------------------------------------------------------------------
---------------------------------------------------------------------------------------------------------------------------------------------------------------------------------------------------------
----------------B-------------------------o--------------------------------------------?-----------XBB-------------B??----------------------------o----XBBM--X-------------------------------------------
------B--------------X--------------------------------------------------------------B--o-------------------------------------------------o---------B------o--------o-M-------------M-----------B----XB---
------------------B------------------------o--------------XM------------------B-------------------------MBM-------------------??-o---------BM------o--------------o---M---BXB----------------------------
-------B-B--------o----------------B---------------------------oB-B-----B-B-------------XM---BBX-------------------------------------B--------o-----------------------------o-B-oE-----BB----------------
-------------------------B------B------M---------------B--------------------------B-----o---------?---o--------------------XB-----------------------------M----------------------------------------------
--------o-------B------------X----------------M---------------------o---------X--------------------------------------------o------------X-B---------------o----------------------------------XB--------v-
--------------B----------------------------------------------------------------------------------------------------M-----------------------------------BB----o--------------------B------------------B-f-
---------------------------------------------------------------------------------M---------------------------------------------M---B-------------------------------------------------------------------f-
----------B------o--X-B----o-----------------o-------------------BB-----?----------------------------X-------------------o------------------o-----M---------------o---------oXB----------??o----M------f-
-----XB-----B---B------X---o-B-?B------?BB-----oXXo--------o----------XB-----?oo--o-----B-o---B--------BM---B------ooo----oXM---------------o--BBB---oM-o--------oo-o-------------?-M-------MM?--o-----f-
-----o-------BB--T---o-------o--oTo-B--o--BB------ooo-o-------------o----BB------oo-------o---o-----oo-------------o-o----o---oo---------BBo-B------o--T---------T-o------o--o--BB----o--------------o-f-
-----------------|---o-----------|oo--------------T-------T------oo-----------T--T--------T----o----oo-------------T----------oo---o----------------T--|---------|--------------------o-T--------T-----f-
m---------E------|---T--T--------|T---------------|--T----|------T------------|--|-E-----E|----T----T--------------|----------TE---T----------------|--|--E------|-----------------E-T--|-T------|-----X-
X---XXXXXXX--XXX-|XXX|XX|X-XXXX-X||XXXX-XXXX-XXXXX|XX|XXXX|XXXXXX|XX-XXXXXXXXX|XX|XXXXXX-X|X-XX|XX-X|XXXXXX-XXX-XXX|-XXXX---XX|XXX-|XXXXXXX-XXXXXXXX|XX|XXXXXX-XX|XXXXXXXXXXXXXXXXXXX|XX|X|XXXXXX|XX--XX-
