---------------------------------------------------------------------------------------------------------------------------------------------------------------------------------------------------------
---------------------------------------------------------------------------------------------------------------------------------------------------------------------------------------------------------
------------------------B-----------------------------BB------------------------------?--------------BB----------------------------------------BM-------------o----BBM------X----?MB---o--o--------?-----
----------------------------------------------------------------------M?---o--------------------XB-------B?M--------------------------------BB---------------------------o-----?Mo-----------------------
--------------------------B--o--------------o-BB---X----o-B--B-----------------------------------------------------BX-------------------o----o--------------------------------------------------B?B------
--------------------------o--------------MX------------------------------------------------X-------------------?------------M-o-------------------------B------BBMB----------------------BB--------------
------------------------------------------------------------------o-------------------B-???------BMX------------------------------------------------------------------B----X-----------------------------
--------oB----------B-M-----M---------BM----B-B-------------BBB---------B-----------------o------------MB-BB-----------------------------------XM---------------------o----------BBB-----------------B-v-
---------------------------------B-BB------------------BB-------------------------------------MX--------------------------o----------------------------------------------?------------------------?----f-
--------------------------------------------------o-----------------------------o---------------------------------------------------------------------------------------------------E------------------f-
-------XM?M------------------------------------M--------o-----------o----------o---X--o-----------o-o--------o----------------------?-BM----------------------XMBB-----?B--ooE-E----B?B---o-----o--o---f-
--------o-----XM--Eooo----BMM----B?MBM------??B--------o-----X?o----------B?-------------M--o----Xoo-----------o------------?---XB-------?BM?------o-BM----X--oo-o-----------XBB-MB----------o---------f-
-----------o-------oo-o------oo---------o-----o--o-BBB-T---------B----oB----B-----o--------T--BBB-T---o----oooooo-------------B----------o-o--B---oo---o----B-----B---oo---T------------ooo--T-oo-Too--f-
-----------o-------T-T------------------o---------o----|--o----T---------------------------|------|---------o-T-----------------------oo----------T-------------------T----|-------T------o--|-o--|----f-
m----------T-------|-|--E-----------E-TT---------T----E|-T-----|-----------------E---------|------|---T-----T-|-----------------------T------E----|-------------------|----|------E|----TT---|TT--|----X-
X---XXXX-XX|XXXXXXX|X|XXXXXXX-XXXXXXXX||XXXXXXXXX|--XXX|X|XXXXX|XXXXXXXXXXXXXXXXXXXX-XXXXXX|XXXXXX|XXX|XXXXX|-|XXXXXXXXXXXXXX-XXXXX-XX|X-XXXXXXXXX|XXXXXXXXXXXX-XXXXXX|X--X|XXXX--X|XXXX||XXX|||XX|-XXXX-
