---X-----------------------------------------------------------------------------------------------------------------------------------------------------------------------------------------------------
--------------------------------------------------------------------------------X------------------------------------------------------------------------------------------------------------------------
----o--------------------------???-----------------------------------M-----------------------------------------------------------------------------------------------------------------------------o-----
---------------------------------------------------------------------------------B------------------------------------------------------------B----------------------------------------------------------
----------------------------------------M-----------------------------B--------------------------------------------------------------------------------------Xo------------------------------------------
------------------------------------------?----------------------X-----------------------o----------?---------------------------------------------------------------------------X------------------------
----------------------------------------------------------------XX-------------------o-------------------------------------------------------------------------------------------------------------------
---------------------------------------------------------------XXX----X--X???????--------------o------------------?T------------------------B----------------------------------------------------------v-
-------------X-------------------------------------BBBB-------XXXX---------------------------------------?---------|----------------------------?------------------------------------------------------f-
-----------------o-------------------------------------------XXXXX---------------------------------------------T---|----------------------------------o---M------------------T-------------------------f-
------------------------------------------------------------XXXXXX--------------------------------------BBBBB--|---|---------------------------------------------------oXXX--|--------????-------------f-
------------------------M------M---------T--T--------------XXXXXXX------------------------------------o--------|---|-----------------------o------------------T-----X--------|-------------------------f-
-----------------------------------------|--|-------------XXXXXXXX-------------------------------------------??|?--|-----------------------------T------------|--------------|-------------------------f-
---------o---------------------M---------|--|------------XXXXXXXXX-----T-------------T------------------------X|---|-----------------------------|------------|--------------|-------------------------f-
m--X------E------------E-------E---------|--|-----------XXXXXXXXXX--E--|-------------|--E----------------------|-E-|-E-----X------------E--------|----E-------|--B-----------|--------------------E----X-
XXXXXXXXXXXXXXXXXXXXXXXXXXXXXXXXXXXXX-XXX|XX|XXXXXXXXXXXXXXXXXXXXXXXXXX|XXXXXXXXXXXXX|-XXXXXXXXXXXXXXXXXXXXXXXX|XXX|XXXXXXXXXXXXXXXXXXXXXXXXXXXXX|XXX------XXX|XXXXXX------XX|XXXXXX--XXXXXXXXXX-------X-
