---------------------------------------------------------------------------------------------------------------------------------------------------------------------------------------------------------
---------------------------------------------------------------------------------------------------------------------------------------------------------------------------------------------------------
------o-------------------------------------------------------------------X--------------B----------------------B-------------------------------------------XB------------------------------?------------
------------------------------------------B----------X?------------------------------------------------------B?------------------B-------------B---o-----------------------------------------------------
-------------------XXB----------------------------------------B---------------?-B-------------o--------------------------------------B--------------------------------------BB---------------------B-M---
---------------------o-----------X-----------------------------------M-----------------------------------------------------------------------------------------------------------------B-MB--------------
------B---------XM---------o-------B?B----MB-E-----------?-?B------------?----------o------?B--------------------------B---------------------B-------------------------M--------------o------------------
--------------------------------------------------B------------?X----o-----------o---------o--------------------------------------------?M-o------oB---------------------B-B-B-------------------------v-
--------------o------------------------------XB?B-------------------------------------------------------------------------------------------o------------------------------------------------o---------f-
-------------------------------------------------o------------------------------------B--o---------------------------B---------B-----------------------------------------------------------------------f-
------X--XMM----------o--------E----MM---------o---------------------M----------M----------oo-o----oo----------MXBBBo----------------------------?B----B?B?M------------BX-------------------------o?X-f-
-------B-------XX-o-------X-?B?---------o---ooo-------??--o---MM--------XM--o--------------ooooXoo---o-X----------------o---XB-----------BB---o----?MBMo----------XB------BXBM-----BX-XB?M-BM?----oo---f-
-----------o-BBo-o--------o----B--------o--ooTTB--o-----BB-B--o-------------o--o---------B-T-To-oo--T-o--o--------------------BB--o--------B-T-BB-----o-------------------o--o------o-------------T----f-
-----------------o---------------------T--TT-||------------------T-----o----T--------------|-|--T---|-------------o---------------o----------|----------------------------------------------------|----f-
m----------T-----T---------------------|--||-||------------------|----T-----|------E-------|-|--|--E|------------T------E--------T-----------|---------E------------E------------E----------------|----X-
X-----XXXXX|XX--X|-XXXXXXXXXXX-XXXXXXXX|-X||X||X-XXX---XXXXX-XX-X|XXXX|XXX-X|XX-XXXXXXXXXXX|X|-X|XXX|XXXXXXXXXXXX|XX---XXXX-----X|XXXXXXXX-XX|XXXXXXX--XXXXXXXXXXXXXXXXXXXXXXXX-XXXXXXXXX-XXXXXXXX|X--XX-
