-----------------------BXXXXX----------------------------------------------------------------------------------------------------------------------------------------------------------------------------
---------------------------------------------------------------------------------------------------------------------------------------------------------------------------------------------------------
-------------------------------???-----------------------------------M-----------------------------------------------------------------------------------------------------------------------------o-----
------------------------------------------------------------------------M-----------------------------------------------------------------------o--------------------------------------------------------
-----------------------------B----------------------------------------B--------------------------------------------------------------------------------------Xo------------------------------------------
----------------------o----------o--------?----------------------X----------------------------------?---------------------------------------------------------------------------X------------------------
----------------------------------------------------------------XX---------------------------------------------------------?????-------------------------------------------------------------------------
---------------------------------------------------------------XXX--------???????---------------------------------?-------------------------B----------------------------------------------------------v-
--------------------------------------------------------------XXXX------------------------------------------------------------------------------?-----------------X------------------------------------f-
-------------------------------------------------------------XXXXX---------------------------------------------T--------------------------------------o----------XX----------T-------------------------f-
---------------------------B--------------------------------XXXXXX---------------------------------------------|------------------------------------------------XXX-----XXX--|-------------------------f-
---------------B--------M----------------T-----------------XXXXXXX-----------------------------------X---------|----------------------------------------------TXXXX-X--------|-------------------------f-
-----------------------T---------------T-|----------------XXXXXXXX----------------------------------XX-------??|?---------------------------------------------|XXXX----------|-------------------------f-
----------------M------|---------------|-|---------------XXTXXXXXX-o---T-------------T-------------XXX---------|---------------------------------------------X|XXXX----------|-------------------------f-
m----------------------|---------------|-|E-------------XXX|XXXXXX-----|-------E-----|------X-----XXXX---------|-E------------------------------------E-----XX|XXXX----------|---E----------------E----X-
XXXXXXXXXXXXXXXXXXX----|XXXXXXXXXXXXXXX|X|XXXXXXXXXXXXXXXXX|XXXXXXXXXXX|XXXXXX-------|XXXXXXXXXXXXXXXXXXXXXXXXX|XXXXXXXXXXXXXXXXXXXXXXXXXXXXXXXXXXXXX------XXX|XXXXXX------XX|XXXXXX--XXXXXXXXXXXXXXXXXX-
