-----------------------------------------o---------------------------------------------------------------------------------------------------------o-----------------------------------------------------
---------------------------------------------------------------------------------------------------------------------------------------------------------------------------------------------------------
---------------------------------------------------------------------------------------------------------------------------------------------------------------------------------------------------------
---------------------------------------------------------------------------------------------------------------------------------------------------------------------------------------------------------
---------------------------------------------------------------------------------------------------------------------------------------------------------------------------------------------------------
----------------------------------------------------------------------B----------------------------------------------------------------------------------------------------------------------------------
---------------------------------------------------------------------------------------------------------------------------------------------------------------------------------------------------------
---------------------------------------------------------X-------------------------X-------------------------------------------------------------------------------------------------------------------v-
--------------------------------------------------------XX--------------------------------------------------------------------------o------------------------------------------------------------------f-
-------------------------------------------------------XXX---------------------------------------------------------------------------------------------------------------------------------------------f-
---------------------X--------------------------------XXXX---------------------------------------------X------------------------------------------------------------------------------------------B----f-
---------------------------------------B-------------XXXXX-------------------------X-------------------------------------------------------------------------------------------------------------------f-
----------------------------------------------------XXXXXX------------------------XX------------------------------------------------------------------------------------------------------------T------f-
---------------------------------------------------XXXXXXX-----------------------XXX--------X--------------------------------------------------------------------------BBBBBBB------------------|------f-
m-------------------------------------------------XXXXXXXX----------------------XXXX-----------------------------------------------------------------------------------------------------E------|------X-
XXXXXXXXXXXXXXXXXXXXXXXXXXXXXXXXXXXXXXXXXXXXXXXXXXXXXXXXXXXXXXXXXXXXXXXXXXXXXXXXXXXXXXXXXXXXXXXXXXXXXXXXXXXXXXXXXXXXXXXXXXXXXXXXXXXXXXXXXXXXXXXXXXXXXXXXXXXXXXXXX-------XXXXXXXXXXXXXXXXXXXXXXXX|XXXXXXX-
