---------------------------------------------------------------------------------------------------------------------------------------------------------------------------------------------------------
---------------------------------------------------------------------------------------------------------------------------------------------------------------------------------------------------------
---------------------------------------------------------------------------------------------------------------------------------------------------------------------------------------------------------
----------------------------------------------------------------------------------------------------------------------------------------------------------------------------------------------BBBBBB-----
---------------------------------------------------------------------------------------------------------------------------------------------------------------------------------------------------------
----BBBB----------------------------------------------X--------------------------------------------------------------------------------------------------------------------------------------------------
-----------------------------------------------------XX--------------------------------------------------------------------------------------------------------------------------------------------------
----------------------------------------------------XXX-------------------------------------------------------------------------------------o----------------------------------------------------------v-
-------------------------X-------------------------XXXX-----------------o------------------------------------------------------------------------------------------------------------------------------f-
--------------------------------------------------XXXXX------------------------------------------------------------------------------------------------------------------------------------------------f-
-------------------------------------------------XXXXXX------------------------------------------------------------------------------------------------------------------------------------------------f-
------------------------------------------------XXXXXXX------------------------------------------------------------------------------------------------------------------------------------------------f-
-----------------------------------------------XXXXXXXX------------------------------------------------------------------------------------------------------------------------------------------------f-
----------------------------------------------XXXXXXXXX------------------------------------------------------------------------------------------------------------------------------------------------f-
m--------------------------------------------XXXXXXXXXX---------------------------------------------------------------------------------------------------------------------------E--------------------X-
XXXXXXXXXXXXXXXXXXXXXXXXXXXXXXXXXXXXXXXXXXXXXXXXXXXXXXXXXXXXXXXXXXXXXXXXXXXXXBXXXXXXXXXXXXXXXXXXXXXXXXXXXXXXXXXXXXXXXXXXXXXXXXXXXXXXXXXXXXXXXXXXXXXXXXXXXXXXXXXXXXXXXXXXXXXXXXXXXXXXXXXXXXXXXXXXXXXXXXXX-
