---------------------------------------------------------------------------------------------------------------------------------------------------------------------------------------------------------
-------------------------------------------o-------------------------------------------------------------------------------------------------------------------------------------------------------------
--o------------------------------------------------------------------------------------------------------------------------------------------------------------------------------------------------------
---------------------------------------------------------------------------------------------------------------------------------------------------------------------------------------------------------
---------------------------------------------------------------------------------------------------------------------------------------------------------------------------------------------------------
---------------------------------------------------------------------------------------------------------------------------------------------------------------------------------------------------------
---------------------------------------------------------------------------------------------------------------------------------------------------------------------------------------------------------
-------------------------------------------------------------------------------------------------------------------------------------------------------------------------------------------------------v-
-------------------------------------------------------------------------------------------------------------------------------------------------------------------------------------------------------f-
-------------------------------------------------------------------------------------------------------------------------------------------------------------------------------------------------------f-
---------------o----------------------------------------------------------------------------------------------------------XX---------------------------------------------------------------------------f-
-----------------------------------------------------------------------B-------------------------------------------------------------------------------------------------------------------------------f-
-------------------------------------------------------------------------------------------------------------------------------------------------------------------------------------------------------f-
--------------------------------------??????-----------------------------------------------------------------------------------------------------------------------------------------------------------f-
m-------------------------------------------------------------------------------------------------------------------E-------------------------------------------------------------------------E--------X-
XXXXXXXXXXXXXXXXXXXXXXXXXXXXXXXXXXXXXXXXXXXXXXXXXXXXXXXXXXXXXXXXXXXXXXXXXXXXXXXXXXXXXXXXXXXXXXXXXXXXXXXXXXXXXXXXXXXXXXXXXXXXXXXXXXXXXXXXXXXXXXXXXXXXXXXXXXXXXXXXXXXXXXXXXXXXXXXXXXXXXXXXXXXXXXXXXXXXXXXX-
