-------------------------------------------------------------------------------------------------o-------M---------------------------------------------------B-------------------------------------------
---------------------------------------------------------------------------------------------------------------------------------------------------------------------------------------------------------
------------o---------------------------------------------------------------------------------------BBBBBBB--------------------------------------------------------------o-----------?----------------B--
-----------------------------------------------------------------------------------------------------------M---------------------------------------------------------------------------------------------
-------------------BBBBB---------XX-----------------BBBBBBB------------------B----------------------B---------------------------------------------------------------------?------------------------------
---------------------------------------------------------------------------------------------X------------------------------------B---------------------------------------------o------------------------
------------------------------------------------B-------------------------------B---T-------XX-----------------------------------------------------X-----------------------------?--------BBBBBBB--------
--------------------------------?---------------------------------------------------|------XXX-----------T--------------------------------------------------------------------------------------BB--T--v-
------------------------------B-----------------------------------------------------|-----XXXX-----------|----------------------------------------------------------------------------X-------------|--f-
------M-----------------------------------------------------------------------------|----XXXXX-----------|-----------X------------?-------------------------------------------------------------X---|--f-
-----------------------T-------------------------------------------------------T----|-XXXXXXXX-----------|-----X----------------------------XXX------------------------------------------------XX---|--f-
-----------------------|------------------------------------------------------B|----|--XXXXXXX-----------|------------------------------------------------------------------------------------XXX---|--f-
------------------B----|------------------------B------------------------------|----|-XXXXXXXX-----------|-------------------------?-----------------------------------------------??????----XXXX---|--f-
-----------------------|-------------------------------------------------------|----|XXXXXXXXX-----------|----------------------------------------------M-------------------T---------------XXXXX---|--f-
m---------------------E|-X-------------------------------------------E---------|----|XXXXXXXXX-E-----X---|-E----------E--------------------------E--------------------------|--------------XXXXXX---|E-X-
XXXXXXXXXXXXXXXXXXXXXXX|XXXXXXXXXXXXXXXX------XXX------XXXXXXXXXX-XXXXXXXXXXXXX|XXXX|XXXXXXXXXXXXXXXXXXXX|X------XXXXXXXXXXXXXXXX----XXXXXXXXXXXXXXXXXXXXXXXXXXXXXXXXXXXXXXX|X---XXXXXXXXXXXXXXXX---|--X-
