---------------------------------------------------------------------------------------------------------------------------------------------------------------------------------------------------------
---------------------------------------------------------------------------------------------------------------------------------------------------------------------------------------------------------
-----------------------o--------B--------o----------------X------o-------------------------------------?---------------------------------------X--------o-------------o----------------------------------
-----------------------------X----B---------------------------------o-----?----X----------M---------E------------------------------?BM----------XB-----------o------------------------------------X------
---------------B----------M-----------------------BM--------MM----------------------------------------------------------B-B-----------------------------------------------------------------------o------
-------X--?-----------BB-----------------MX----------------------XB-------------B-----o-----M-X?--------------------------------------MB--------------?BB-------B-----BB------M------BBB-------M---------
---------------o-----------?------------------o-------?M--------------BB-------------------------------B------------BB--------------------B--------------------------------------------------BB-----o----
--------B----BB-----------------------------------------------------------------------o---------------o---o--------------------------------------------------------------------------------------------v-
-----------------------------------B--------------------------B------------------------o-B--------------------------------B------------------------------------------------------------B----------BB---f-
---------------------------------o------------------------B-----------B-------------------B------------------------------------------------------------------------------------------------------------f-
--------?----------B-----------o-------------BB-M----------------BXMM----B----------------------------------------------------XM-B?--B-MB-----o----------o---------------------------------------------f-
---------X?B---------o?-B-----o---o--o--------o---------------------------B----o----o--------XM---BX--o--XB----------MBM?oo---------------?-----------?B-oo------?XX---------BM--?---o---BMB?BB-BBX?oo-f-
--------o----BB----o----oo--o-TB-----------------B-o-B---------o---oo--oo-oBB---o--oo---o-------------T------------oooo--oo--------------o----T---------oo-o---------BBo-------B--o-T---------------T--f-
--------------------o---o-----|--------------------------------o----o--ooo--------T----T--oo----------|------------T-----T----------------o---|---oo----T--oo-----------------------|---------------|--f-
m------T-----------T---T-----E|------------------------E-------T---T--T-T---------|T---|--T-----------|----E--T--T-|-----|------------E-ET----|---T-----|-ET---------------E------T-|---------------|--X-
X---XX-|XXXXXXXXXXX|XXX|-XXXXX|XXXXXXXXXX-XXXXXX-XX-XXXX-XXXXXX|XXX|X-|X|XXXXXXXXX||XXX|X-|XXXXXX-XX-X|XXXXXXX|XX|X|XXXXX|XX-XXXXX-XXXXXX|XXXX|XXX|XX-XX|XX|XXXXXXXX-XX-XXXXXX-XXX|-|XXXXXXXXXXXX-XX|XXX-
