B------------------------------------------------------------------------------------------------------------------------------------------------------------------------------------------------------?-
-------------------------------------------------------------------------------------------------------------------------------------------------------------------------------------------------------X-
|-------?M-------------------------------------------------------------B-----------------X---------X-MB-----------------X---------------B--------------------------------XB------------o-?B----------X-?-
?------------------------------------B-------o--------------------------------------------BB----o----------------------------------------?--------------B??---------------------------------B----------B-
E-----------M------XB----------------------------------------------------------------------------------------------o---------B---X-------------M----------o-------B-E-------MM-------------------B-----o-
T------------------------------------------------------------BB-----B----------M------B-----M?--------------------------------X----------------------------B---------o-------------------------o-------M-
X--------------B-----------?--------B--------------------------------------------?-----------------------------o--------BB----------------------------------B--------------------------------B---------T-
T---------BM--------------------------------------MB-----------------BB-------------------------BB--?---?M?----o--?--------------------MX-------------o-?--------o-------------------------------------v-
B--------------------------o----o-----------------------o---------o---------B-----------------?X-----------B--o------------------------------M----------------------BM---------E---------??------------E-
E-----------------------------------------E-------------------B--------------B-------------------------------------------------------------------------------------------------------------------------M-
o-----------------------------------B---------------o--o---B--o----o------o------BB?M------XM?------ooX-----------------------------------------BM------o-X----?-----------B----oo-------------------BX?-
X----BM--------XB----------------o------o-o-XM----BBoo--??---oo-B----------------o------------o-X?--o---------BBMXMo--?--B--o-o---Xoo-Mo-BBBB-------------o-----o-------B-----o---o-o-----ooo----------?-
X-------B-o-----------B-----------BB--o-o-----o---ooT-o------T-o-------------BB---------------o--o--T-----BBo---o--o-------oo------o--oT------o---------T----oo--------------o-TT-o-------Too-----T----o-
X--------o-------T--------------T-------T-T----o----|--------|-oo---------------T-------------T-----|--T-----------T---------------T---|----------------|-----oo-------------T-||-T-TT----|T------|----T-
m--------TT------|--------------|------E|-|---T-----|--------|ET----------------|-E-----------|---T-|--|-----------|----E-------E--|---|----E----------E|-----T----EE--------|-||E|-||----||-----E|----?-
X---XXXXX||XXXXXX|XXXXXXXXXXXX-X|X---XXX|X|XXX|-XXX-|XXXX---X|X|X----XXXXXXXXXXX|XXXXXXXXXXXXX|XXX|X|XX|X-XXXXX-XX-|XXXXX-XXXXXXXXX|XXX|XXXXXXXXXXXX---X|-XX-X|XXX-XXX-XXXXXX|X||X|X||XXXX||XXXXXX|X-XXX-
