----------------?---------------------------------------------------M------------------------------------------------------------------------------------------------------------------------------------
------------------------o----------------------?------------------------------?------------------------------------------------o-------------------B-----------------------------------------------------
---------------------------------------------------------------------------------------------------------------------------------------------------------------------------------------------------------
-----------------------------------------------------------------------------------------------------o-------M-----------------------------------------XXXXXXXX---------o--------------------------------
----------------------------------------------------------------------------X-------------------BBBBM----------------------------------------------------------------------------------------------------
---------------X---------------------------------------------------------------------------------o-------------------------------------------------------------------------------------------------------
---------------------------------------------------------------------------------------------------------------------------------------------------------------------------------------------------------
---------------------------------------------------X-------------------------------------------------------------------------------------------------------------------------------------------?-------v-
-----------------------------????????-------------XX----------------------------------------?----------------------------------------------------------------------------------------------------------f-
-------------------------------------------------XXX------------------------------------X----------------------------------------------------------o--------------------X------------------------------f-
---------------------------------------------T--XXXX-----------------------------------XX--------------------------B------------------------------------------------------?????------------------------f-
---------------------------------------------|-XXXXX----------------------------------XXX-------------T----X--------------------?--------------------------X-------------------------------------------f-
--T------------------------------------------|XXXXXX-----------------M---------------XXXX---------o---|-------------------------------T---------------------?------------------------------------------f-
--|-----o------------------------------------|XXXXXX--------------XXXX------M-------XXXXX-------------|-------------------------------|--T-------------------------------------------------------------f-
m-|-----o-----------------------------------X|XXXXXX------------------------------EXXXXXX-------------|-----------------E-------------|--|-----------------E-------------------------------------------X-
XX|XXXXXXXXX-------XoXXXBBBBBBBBXXXXXXXXXX-XX|XXXXXXXXXXXXXXXXX??????XXXXXXXXXX---XXXXXXXXXXXXXXXXXXXX|XXXXXXXXXXXXXXXXXXXXXXXXXXXXXXX|XX|XXXXXXXXXXXXXXXXXXXXXXXXXXXXXXXXXXXX----XXXXXXXXXXXXXXXXXXXXXX-
