---------------------------------------------------------------------------------------------------------------------------------------------------------------------------------------------------------
---------------------------------------------------------------------------------------------------------------------------------------------------------------------------------------------------------
----------------------------------------------------------------------------------------------------?????------------------------------------------------------------------------------------------------
---------------------------------------------------------------------------------------------------------------------------------------------------------------------------------------------------------
-------------------------------------------------------------------------------------------------------------------------------------------------M------------------------B------------------------------
-----?????-------------------------------------------------------------------------BBBBBBBB--------------------------------------------------------------------------------------------------------------
---------------------------------------------------------------------------------------------------------------------------------------------------------------------------------------------------------
-----------------------------------------------------------------------------------------------------------------------------------------------------X-------------------------------------------------v-
-------------------------------------------------------------------------------------------------------------------------------------------------------------------------------------------------------f-
-------------------------------------------------------------------------------------------------------------------------------------------------------------------------------------------------------f-
-----------------------------------------------------M-------------------------------------------------------------------------------------------------------------------------------------------------f-
-T-----------------------------------------------------------------------------------------------------------------------------------------------------------------------------------------------------f-
-|-----------------------------------------------------------------------------------------------------------------------------------------------------------------------------------------------------f-
-|--------------------------------------------------------------------------------------------------------------------------------------------------------------------------------------?--------------f-
m|-----------------------------------------------------------------------------------------------------------------------------------------------------------------------------------------------------X-
X|XXXXXXXXXXXXXXXXXXXXXXXXXXXXXXXXXXXXXXXXXXBBBXXXXXXXXXXXXXXXXXXXXXXXXXXXXXXXXXXXXXXXXXXXXXXXXXXXXXXXXXXXXXXXXXXXXXXXXXXXXXXXXXXXXXXXXXXXXXXXXXXXXXXXXXXXXXXXXXXXXXXXXXXXXXXXXXXXXXXXXXXXXXXXXXXXXXXXXX-
