---------------------------------------------------------------------------------------XXXXXXXX---------------------------------------------------------------------X------------------------------------
---------------------------------------------------------------------XXXX--------------------------------------------------o---------------------------------------------B-------------------------------
-------------------------------------------------------------------------------------------------------------------------------------------------------------------------------------------------o-------
---------------------------------------------------------------------------------------------------------------------------------------------------------------------------------------------------------
----------------X--------------------------------------??---------------------------------------------------------------------BBBBBBB--------------------------------------------------------------------
--o------------XX---------------------------------------------------?------------------------------------------------------------------------------------------------------------------------------------
--------------XXX----------------------------------------------------------------------------------------------------------------------------------------------------------------------?-----------------
-------------XXXX-------------------------------------------B------------------------------------------------------------------------------------------------------------------------------------------v-
------------XXXXX-----------------------------------------B-----------------???------------------------------------------------------------------------------------------------?-----------------------f-
-----------XXXXXX----------------------------------------------------------------------X---------------------------------------------------------------------------------------------------------------f-
----------XXXXXXX---------------------------------------------------------------------XX---------------------------------------------------------------------------------------------------------------f-
---------XXXXXXXX--------------------------------------------------------------------XXX-------------------------------------------------------------------------------???-----------------------------f-
--------XXXXXXXXX-------------------------------------------------------------------XXXX---------------------------------------------------------------------------------------------------------------f-
---B---XXXXXXXXXX--------------------------------------------------------------M---XXXXX---------------------------------------------------------------------------------------------------------------f-
m----EXXXXXXXXXXX--------------------E--------M-----------------------------------XXXXXX----------------------------------E-----------------------------------E-------------E--------------------------X-
XXXXXXXXXXXXXXXXX---------XXXXXXXXXXXXXXX--XXXX-------XXXXXXXXXXXXXXXXXXXXXXXXXXXXXXXXXXXXXXXXXXXXXXXXXXXXXXXXXXXXXXXXXXXXXXXXXXXXXXXX--------XBX---XXXXXXXXXXBBBBBXXXXXXXXXXXXXXXXXXXXXXXXXXXXXXXXXXXXX-
