---------------------------------------------------------------------------------------------------------------------------------------------------------------------------------------------------------
--------------------------X--------------------------------------------------------------------------------------------------------------------------------------------------------------------o---------
---------------------------------------------------------------------------------------------------------------------------------------------------------------------------------------------------------
---------------------------------------------------------------------------------------------------------------------------------------------------------------------------------------------------------
---------------------------------------------------------------------------------------------------------------------------------------------------------------------------------------------------------
---------------------------------------------------------------------------------------------------------------------------------------------------------------------------------------------------------
---------------------------------------------------------------------------------------------------------------------------------------------------------------------------------------------------------
-------------------------------------------------------------------------------------------------------------------------------------------------------------------------------------------------------v-
-------------------------------------------------------------------------------------------------------------------------------------------------------------------------------------------------------f-
-------------------------------------------------------------------------------------------------------------------------------------------------------------------------------------------------------f-
-------------------------------------------------------------------------------------------------------------------------------------------------------------------------------------------------------f-
--------------------------------------------------------------------------------------------------------------------------------------------X----------------------------------------------------------f-
--------------------------------------------------------------------------------------------------------------------------------------------XX----------------------X----------------------------------f-
-----------------------------------------------------------------------------------------------------------------------------------------X--XXX--------------------XX----------------------------------f-
m----------------------------------------------------------------------------------------------E--------------------------------------------XXXX------------------XXX----------------------------------X-
XXXXXXXXXXXXXX-XXXXXXXXXXXXXXXXXXXXXXXXXXXXXXXXXXXXXXXXXXXXXXXXXXXXXXXXXXXXXXXXXXXXXXXXXXXXXXXXXXXXXXXXXXXXXXXXXXXXXXXXXXXXXXXXXXXXXXXXXXXXXXXXXXXXXXXXXXXXXXXXXXXXXXXXXXXXXXXXXXXXXXXXXXBBBBBBBXX-----X-
