-------------------------------------------------------------------------------------------------------------------------------------------------------------o-------------------------------------------
---------------------------------------------------------------------------------------------------------------------------------------------------------------------------------------------------------
---------------------------------------------------------------------------------------------------------------------------------------------------------------------------------------------------------
---------------------------------------------------------------------------------------------------------------------------------------------------------------------------------------------------------
---------------------------------------------------------------------------------------------------------------------------------------------------------------------------------------------------------
---------------------------------------------------------------------------------------------------------------------------------------------------------------------------------------------------------
--------------------------------------------------------------o----------------------------------------------------------------------------------------------------------------X-------------------------
--------------------?-------------------------------------------------------------------------------------------------------------------------------------------------------------------------B--------v-
-------------------------------------------------------------------------------------------------------------------------------------------------------------------------------------------------------f-
--------------------------------------X----------------------------------------------------------------------------------------------------------------------------------------------------------------f-
--------------------------------------XX---------------------------------------------------------------------------------------------------------------------------------------------------------------f-
-----------------------------XXXXXXX--XXX--------------------------------------------------------------------------------------------------------------------------------------------------------------f-
--------------------------------------XXXX----------------------------------------------------------------------------------------------------------------------------o--------------------------------f-
--------------------------------------XXXXX------------------------------------------------------------------------------------------------------------------------------------------------------------f-
m-------------------------------------XXXXXX----------------------------------------------------------------------------------------------------------------------------E---------------X--------------X-
XXXXXXXXXXXXXXXXXXXXXXX-------XoXXXXXXXXXXXXXXXXXXXXXXXXXXXXXXXXXXXXXXXXXXXXXXXXXXXXXXXXXXXXXXXXXXXXXXXXXXXXXXXXXXXXX--XXXXXXXXXXXXXXXXXXXXXXXXXXXXXXXXXXXXXXXXXXXXXXXXXXXXXXXXXXXXXXXXXXXXXXXXXXXXXXXXX-
