---------------------------------------------------------------------------------------------------------------------------------------------------------------------------------------------------------
----------------------------------------------------------------------------------------------------------------?----------------------------------------------------------------------------------------
-------------------------------------------------------------B---------------------------------------?????-----------------------------------------------------------------------------------------------
---------------------------------------------------------------------------------------------------------------------------------------------------------------------------------------------------------
---------------------------------------------------------------------------------XXXXX----------------------------X--------------------------------------------------------------------------------------
-----------------------------------------------------------------------------------------------------------------XX--------------------------------------------------------------------------------------
----------------------------------------------------------------------------------------------------------------XXX--------------------------------------------------------------------------------------
---------------------------------------------------------------------------------------------------------------XXXX------------------------------------------------------------------------------------v-
--------------------------------------------------------------------------------------------------------------XXXXX------------------------------------------------------------------------------------f-
-------------------------------------------------------------------------------------------------------------XXXXXX-----------o------------------------------------------------------------------------f-
----------o-------------------------------------------------------------------------------------------------XXXXXXX-----B------------------------------------------------------------------------------f-
-----------------------------------------------------------------------------------------------------------XXXXXXXX------------------------------------------------------------------------------------f-
----------------------------------------------------------------------------------------------------------XXXXXXXXX------------------------------------------------------------------------------------f-
---------------------------------------------------------------------------------------------------------XXXXXXXXXX------------------------------------------------------------------------------------f-
m---------------------------E----------------------E----E-----------------------------------------------XXXXXXXXXXX--------------------------------------------------------------EE--------------------X-
XXXXXXXXXXXXXXXXXX---XXXXXXXXXXXXXXXXXXXXXXXXXXXXXXXXXXXXXXXXXXXXXXXXXXXXXXXXXXXXXXXXXXXXXXXXXXXXXXXXXXXXXXXXXXXXXXXXXXXXXXXXXXXXXXXXXXXXXXXXXXXXXXXXXXXXXXXXXXXXXXXXXXXXXXXXXXXXXXXXXXXXXXXXXXXXXXXXXXX-
