B------------------------------------------------------------------------------------------------------------------------------------------------------------------------------------------------------?-
-------------------------------------------------------------------------------------------------------------------------------------------------------------------------------------------------------X-
|-----M---------------------------M----?B------------------------------------o--B----X-------------------------------------------------------------------------------------------------------B-X-?-----?-
?----------------------------X-----------------------------------M---------------------B-----------------o--B-------------------------------------------------------------------------------------B----B-
E-------------------------B-----------------------------------------------------------------------BM----------------M---------------------B-----------------------------------------------BM-----------o-
T-------------------------------M---------------------X---------------------------------------------E-------------o---------------------------------------------B--------------------o-----------------M-
X-------------------------------------------------------------------------------------------------------------?B---------------?--X---------------------X--M?-------B----------------------------------T-
T---------o---?----------B----o---------------------------------------------------------------------?M---------------------------------------?----------o--------X--------------X--------------------?-v-
B----?---o----------o------------------------------------------B-----------------------B------------------------------------------o--------B--B--------------------------?B------M?--------------------E-
E------------------------------------------------------------------------------------------------------------------------B-------------------------------------E---------------------------------------M-
o-----------------------BB---------------------X?-----------o-------------X-------------------M?--------------??MB?--------o-----------o-o------------------??M-E-------------oo-----BB-----X-----o----?-
X------------MX-----Moo-o------XB------------o-o----B-MBB--------------BX----MXX----------------??X----??---------------o-oo---XBB-----------------------oo-----------Xo-o--oooo-----------oo-------MM-?-
X----------BB---o----oo-o-----------Boo--o-----o--o------o-----------------B-o---------oo------------T-----------o--B-o----To------o--oT---B------B------T-----BB---BB-ooo-oTTTBB--BBo-----o----o-T---oo-
X---------------TT-ooT-T-----------------o--T----T-------------------------------------o-------------|---------------------|-----------|-----------------|-------------T-TT-|||-------------------|----T-
m---------------||-T-|-|-------------T---T--|----|------------------------------EE-----T--E-T--------|---------------------|-------T---|-----E-----------|-------------|-||-|||------TE-----------|----?-
X---XXXXXXXXXXX-||X|X|X|XXX-XXXXXXXXX|XXX|XX|---X|XXXXXXXXXXXXXXXXXXXX---XXXX-XXXXXXXXX|XXX-|X-XXXXXX|-XXXXXXXXXXXXXXXX-XXX|XXXXXX-|XXX|XXXXXXXXXXXXXXX--|XXXXXX-XX-XXX|-||X|||XXXXXX|X---XX-XXXXX|X-XXX-
