---------------------------------------------------------------------------------------------------------------?-----------------------------------------------------------------------------------------
---------------------------------------------------------------------------------------------------------------------------------------------------------------------------------------------------------
---------------------------------------------------B-------------------------------------------------------?---------X-----------------------------------------------------------------------------------
---------------------------------------------------------------------------------------------------------------------------------------------------------------------------------------------------------
----------------------------------------------------------------------------------------------------------------------------------------------------------------?----------------------------------------
---------------------------------------------------------------------------------------------------------------------------------------------------------------------------------------------------------
---------------------------------------------------------------------------------------------------------------------------------------------------------------------------------------------------------
----------------------------------------XX-------------------------------------------------------------------------------------------------------------------------------------------------------------v-
-------------------------------------------------o--------------------------------------------------------------------------BBBBB---------?------------------------------------------------------------f-
-------------------------------------------------------------------------------------------------------------------------------------------------------------------------------------------------------f-
-------------------------------------------------------------------------------------------------------------------------------------------------------------------------------------T-----------------f-
-----------------------X------------------------------------------------------------------------------------------------------------------------------------------------------------B|BBBBB------------f-
----------------------XX-------------------------------------------------------------------------------------------------------------------------------------------------------------|-----------------f-
---------------------XXX-------------------------------------------------------------------------------------------------------------------------------------------------------------|-----------------f-
m-------------------XXXX----------------------------------E-------------------------------------------------------------------------------------------------------------E------------|-----------------X-
XXXXXXX?XXXXX-XXXXXXXXXXXXXXXXXXXXXXXXXXXXXXXXXXXXXXXXXXXXXXXXXX------XXXXXX---XXXXXXXXXXXXXXXXXXXXXXXXXXXXXXXXXXXXXXXXXXXXXXXXXXXXXXXXXXXXXXXXXXXXXXXXXXXXXXXXXXXXXXXXXXXX------XXX-|XXXXXXXXXXXXXX-XXX-
