---------------------------------------------------------------------------------------------------------------------------------------------------M------------?----------------------------------------
---------------------------------------------------------------------------------------------------------------------------------------------------------------------------------------------------------
--------------------------------------------------------------------------------------------------------B------------------------------------------------------------------------------------------------
---------------------------------------------------------------------------------------------------------------------------------M-----------------------------------------------------------------------
----------------------------------------------------------------------------------------o----------------------------------------------------------------------------------------------------------------
---------------------------------------------------------------------------------------------------------------------------------------------------------------------------------------------------------
--------------------------------------------------------------------------------------------------------------B------------------------------------------------------------------------------------------
-------------------------------------------------------------------------------------------------------------------------------------------------------------------------------------------------------v-
---------------------------------------------------------------------------------------------------------------X---------------------------------------------------------------------------------------f-
---------------BB-----------------------------------------------o---------------------------------------------XX------?--------------------------------------------------------------------------------f-
-------------B-----------------------------------------------------------------------------------------------XXX---------------------------------------------------------------------------------------f-
------------------------------------------------------------------------------------------------------------XXXX--------------------------------------------B------------------------------------------f-
-----------------------------------------------------------------------------------------------------------XXXXX---------------------------------------------------------------------------------------f-
---------------------------------------------------------------------------------------------X------------XXXXXX----------------------------------------------------------X----------------------------f-
m-----------------------------E------------------------------------------------------------EXX-----------XXXXXXX-------------------E--------------------------------------XX---------------------------X-
XXXXXXXXXXXXXXXXXXXXXXXXXXXXXXXXXXXXXXXXXXXXXXXXXXXXX--XXXXXXXXXXXXXXXXXXXXXXXXXXXXXXXXXXXXXXXXXXXXXXXXXXXXXXXXXXXXXXXX----------XXXXXXXXXXXXXXXXXXXXXXXXXXXXXXXXXXXXXXXXXXXXXXXXXXXXXXXXXXXXXXXXXXXXXXX-
