---------------------------------------------------------------------------------------------------------------------------------------------------------------------------------------------------------
-B-------------------------------------------------------------------B-----------------------------------------------------------------------------------------------------------------------------------
---------------------------------------------------------------------------------------------------------------------------------------------------------------------------------------------------------
---------------------------------------------------------------------------------------------------------------------------------------------------------------------------------------------------------
---------------------------------------------------------------------------------------------------------------------------------------------------------------------------------------------------------
--------------------------------------------------------------------------------------------------------------------------------------------------------X------------------------------------------------
-------------------------------------------------------------------------------------------------------???-----------------------------------------------------------------------------------------------
-------------------------------------------------------------------------------------------------------------------------------------------------------------------------------------------------------v-
-----------------------------------------------------------------------------------------o------------------------------o------------------------------------------------------------------------------f-
-------------------------------------------------------------------------------------------------------------------------------------------------------------------------------------------------------f-
-------------------------------------------------------------------------------------------------------------------------------------------------------------------------------------------------------f-
---------------------------------------------------------------------------------------------------------------------------------------------------------------------X---------------------------------f-
--------------------------------------------------------------------------------------------------------------------------------------------------------------------XX-------XXXXX---------------------f-
-------------------------------------------------------------------------------------------------------------------------------------------------------------------XXX---------------------------------f-
m-----------BBBBB------E-------------------------------------------------------------------------------------------------------E----------------------------------XXXX---------------------------E-----X-
XXXXXXXXXXXXXXXXXXXXXXXXXXXXXXXXXXXXXXXXXXXXXXXXXXXXXXXXXXXXXXXXXXXXXXXXXXXXXXXXXXXXXXXXXXXXXXXXXXXXXXXXXXXXXXXXXXXXXXXXXXXXXXXXXXXXXXXXXXXXXXXXXXXXXXXXXXXX----XXXXXXXXXXXXXXXXXXXXXXXXXXXXXXXXXXXXXXXX-
