---------------------------------------------------------------------------------------------------------------------------------------------------------------------------------------------------------
---------------------------------------------------------------------------------------------------------------------------------------------------------------------------------------------------------
-----------------------?------------------XB---------------------BB-------E------------------------------------------------------BB-----o-------------------------o---------------MB------B----------X---
--------------------B-------------------------??-------------------BBB---------------------XB---------XX---B--------------------------X------------------------------------B-B-------------------B-------
----------------------------------B-----o-------------?---------------------------------------E--MX-------------M----------------------------------------------------------------------------------B-----
-------------------------------B----M-------o--------------------------------------------------------------------------------------------------------------------------------------------------B---------
-----------B-------------------------------------------BB------------------------------------------B--------------BM-----XB------?M-?---------------------------------------BBB?B------------------------
---------------------------------BB-----------XM--------------------------------------------X---------B?-------------------------------------------------------------------------------o-B-----------B-v-
---------------M----------------------------?--------------------------------------B------------------------------o---------o-----------------------------------B-----o-------------X--o-------XBB-----f-
------------------------------------------------------------------------------------------------------------B---------X--------------------------------------------------------------------------------f-
------------MMMoo------------------o-oM----------o-----X----------------------------BB-------------M---------------------------------------MBB?-oo------------o------------Bo-----BB------o-------BBM-of-
------------------BMMB-------X---------------BMB-----------o---o---X?------MB--M-B--o--BBM--?----MM---MBM-------X?MMo--o----------oB?--------o-?-oBBo--------o-----o---MB----o---------BBo-----------o-f-
---------------Too---------o----o--o-----B------Tooo------T-----o-oo--o-----------BB--oo-------oo---------o-------------B----------o--------o---T----o-o-BBBoT--B-o--o----o-TB----------oT--B--------T-f-
---------------|--------------------------------|oo-------|----T-----o---------------------------------------T--------T----------T--------------|------------|-------T------|------------|-----------|-f-
m--------------|--------------------------------|T-T-E----|----|-T---T----------EE---------------------------|--------|----------|--------------|-----E------|---TE--|------|------------|----------E|-X-
X---XXXXXXXXXXX|XXXXXXXXXXXXXXXXXXXXXXXX-XXXXX--||-|XXXXXX|XXXX|X|X-X|XX-XXXXXXXXXXX-XXXX-XXXXXXXXXX-XXXXXXX-|XXX-XXXX|-XXXXXXXXX|X----XXXX-XXXX|XXXXXXXXXXXX|XXX|XXX|XXXXXX|XXXX--XXXX--|X-XXXXX--XX|-X-
