---------------------------------------------------------------------------------------------------------------------------------------------------------------------------------------------------------
---------------------------------------------------------------------------------------------------------------------------------------------------------------------------------------------------------
---------------------------------------------------------------------------------------------------------------------------------------------------------------------------------------------------------
-------------------------------------------------------------------------------------------------------------------B-----------------------------------------------------M-------------------------------
----------------------------------------------------------------------------------------------------------------------------?----------------------------------------------------------------------------
---------------------------------------------------------------------------------------------------------------------------------------------------------------------------------------------------------
------------------------------------------------------------------------------BBBBBB-----------------------------------------------------------------------------------------------------------?---------
-------------------------------------------------------------------------------------------------------------------------------------------------------------------------------------------------------v-
----------------------------------------------------------------------------X---------------------?----------------------------------------------------------------------------------------------------f-
---------------------------------------------------------------------------XX--------------------------------------------------------------------------------------------------------------------------f-
--------------------------------------------------------------------------XXX--------------------------------------------------------------------------------------------------------------------------f-
-----------------------------------------?o------------------------------XXXX-----------------------T--------------------------------------------------------------------------------------------------f-
-----------------------------------------------------------------------?XXXXX-----------------------|--------------------------------------------------------------------------------------------------f-
-----------------------------------------------------------------------XXXXXX-----------------------|--------------------------------------------------------------------------------------------------f-
m---------------------------------------------------------------------XXXXXXX-----------------------|--------------------------------------------------------------------------------------------------X-
XXXXXXXXXXXXXXXXXXXXXXXXXXXXXXXXXXXXXXXXXXXXXXXXXXXXXXXXXXXXXXXXXXXXXXXXXXXXXXXXXX--------XoXXXXXXXX|XXXXXXXXXXXXXXXXXXXXXXXXXXXXXXXXXXXXXXXXXXXXXXXXXXXXXXXXXXXXXXXXXXXXXXXXXXXXXXXXXXXXXXXXXXXXXXXXXXX-
