------------------------------------------------------------------------X--------------------------------------------------------------------------------------------------------------------------------
------------------------------------------------------------------------------------------------------------------------------------------------------------------------------------------------------?--
---------------------------------------------------------------------------------------------------------------------------------------------------------------------------------------------------------
--------------------------------------------------------------------------------------------------------------------------------------------------------------------------------------------------M------
-------------------------------------------------------------------------------o--------------------------------------------------------------------------------------------------------------B----------
---------------------------------------------------------------------------------------------------------------------------------------------------------------------------------------------------------
---------------------------------------------------------------------------------------------------------------------------------------------------------------------------------------------------------
--------------B----------------------------------------------------------------------------------------------------------------------------------------------------------------------------------------v-
-------------------------------------------------------------------------------------------------------------------------------------------------------------------------------------------------------f-
---------------------------------------------------------------------------------------------------------------------------------------------------------------------------------------------o---------f-
--------------------------------------------------------------------------------------------------------------------------------------------o----------------------------------------------------------f-
-------------------------------------------------------------------------------------------------------------------------------------------------------------------------------------------------------f-
--------T-------------------------------------------------------------------------------------------------------BBB------------------------------------------------------------------------------------f-
--------|------------------------------X---------------------------------------------------------------------------------------------------------------------------------------------------------------f-
m-------|-----------------------------XX---------------------------------------------------------------------------------------------------------------------------------------------------------------X-
XXXXXXXX|------XXXXXXXXXXXXXXXXXXXXXXXXXXXXXXXXX-------XXXXXXXXXXXXXXXXXXXXXXXXXXXXXXXXXXXXXXXXXXXXXXXXXXXXXXXXXXXXXXXXXXXXXXXXXXXXXXXXXXXXXXXXXXXXXXXXXXXXXXXXXXXXXX------XXXXXXXXXXXXXXXXXXXXXXXXXXXXX-
