---------------------------------------------------------------------------------------------------------------------------------------------------------------------------------------------------------
---------------------------------------------------------------------------------------------------------------------------------------------------------------------------------------------------------
----------------------------------------------------------------------------------------------------------------------------?----------------------------------------------------------------------------
---------------------------------------------------------------------------------------------------------------------------------------------------------------------------------------------------------
-----------------------------------------------------------------------X---------------------------------------------------------------------------------------------------------------------------------
----------------------------------------------------------------------XX------------------------?--------------------------------------------------------------------------------------------------------
---------------------------------------------------------------------XXX---------------------------------------------------------------------------------------------------------------------------------
--------------------------------------------------------------------XXXX------------------X------------------------------------------------------------------------------------------------------------v-
-------------------------------------------------------------------XXXXX-----------------XX------------------------------------------------------------------------------------------------------------f-
------------------------------------------------------------------XXXXXX----------------XXX---------------------------BBBBBB-----------------------------------------------------------------o---------f-
-----------------------------------------------------------------XXXXXXX-----???????---XXXX------------------------------------------------------------------------------------------------------------f-
----------------------------------------------------------------XXXXXXXX--------------XXXXX------------------------------------------------------------------------------------------------------------f-
----------------------------T----------------------------------XXXXXXXXX-------------XXXXXX------------------------------------------------------------------------------------------------------------f-
----------------------------|---------------------------------XXXXXXXXXX------------XXXXXXX------------------------------------------------------------------------------------------------------------f-
m---------------------------|---------------X------------E---XXXXXXXXXXX-----------XXXXXXXX--------------------------E---------------------------------------------------------------------------------X-
XXXXXXXXXXXXXXXXXXXXXXXXXXXX|XXXXXXXXXXXXXXXXXXXXXXXXXXXXXXXXXXXXXXXXXXX------XXXXXXXXXXXXXXXXXXXXXXXXXXXXXXXXXXXXXXXXXXXXXXXXXXXXXXXXXXXXXXXXXXXXXXXXX-----XXXXXXXXXXXXXXXXXXXXXXXXXXX------XXXXXXXXXXX-
