------------------------------------------o--------------------------------------------------------------------------------------------------------------------------------------------------------------
---------------------------------------------------------------------------------------------------------------------------------------------------------------------------------------------------------
---------------------------------------------------------------------------------------------------------------------------------------------------------------------------------------------------------
-------------------------------------------o-------------------------------------------------------------------------------------------------------------------------------------------------------------
----------------------------------------------------------------------------------X----------------------------------------------------------------------------------------------------------------------
-------------------o-------------------------------------------------------------XX----------------------------------------------------------------------------------------------------------------------
--------------------------------------------------------------------------------XXX----------------------------------------------------------------------------------------------------------------------
-------------------------------------------------------------------------------XXXX-------------------------------------------------?------------------------------------------------------------------v-
------------------------------------------------------------------------------XXXXX--------------------------------------------------------------------------------------------------------------------f-
-----------------------------------------------------------------------------XXXXXX-----------------------------------------------------------------------------X-------------X------------------------f-
-------------------------------------X--------------------------------------XXXXXXX-----------------------------------------------------X--------------------------------------------------------------f-
------------------------------------XX-------------------------------------XXXXXXXX----------------------------------------------------XX--------------------------------------?-----------------------f-
-----------------------------------XXX------------------------------------XXXXXXXXX---------------------------------------------------XXX--------------------------------------------------------------f-
----------------------------------XXXX-----------------------------------XXXXXXXXXX--------------------------------------------------XXXX-------------------------------X-X----------------------------f-
m------B-------------------------XXXXX------X----------------E----------XXXXXXXXXXX--------------------------?----------------------XXXXX--------------------------E-----------------------------------X-
XXXXXXXXXXXXXXXXXX?XXXXX--XXXXXXXXXXXX?XXXXXXXXXXXXXXXXXXXXXXXXXXXXXXXXXXXXXXXXXXXXXXXXXXXXXXXXXXXXXXXX?????------X-----XXXXXXXXXXXXXXXXXXXXXXXXXXXXXXXXXXXXXXXXXXXXXXXXXXXXXXXXXXXXXXXXXXXXXXXX-----XXX-
