-------------------------------------------------------------------------------------------------------------------------------------------------------------B-------------------------XXXXXXX-----------
--------------------------------------------------------------???????--------------------------------------B---------------------------------------------------------------------------------------------
---------------------------------------------B-----------------------------------------------------------------------------------------------------------------------------------------------------------
-------o-------------------------------------------------------------------------------------------------------------------------------------------------------------------------------------------------
---------------------------------------------------------------------------------------------------------------------------------------------------------------------------------------------------------
---------------------------------------------------------------------------B------------------T---------------------------------------------------------------------------------o------------------------
----------------------------------------------------------------------------------------------|----------------------------------------------------------------------------------?--------BBBBBBB--------
--------------------------------------------------------------o----------------?????----------|-----------------------------------------------------------------------------------------------------T--v-
---------------------------------------------------------------------------------------------X|---------------------------------------------------------------------------------------X-------------|--f-
--------T------------------------------o----------------------------XXXXX---------------------|X---------B------------------------------------------------------------------------------------------|--f-
--------|-T--------T-----------------------T--------------------------------------------------|X------------------T---X-----------------------------------------------------------------------------|--f-
--------|-|--------|-----------------------|-------------------------------------------------X|X------------------|??XX?----------------T-----?-----------------------------------------------------|--f-
--------|B|--------|-------------o---------|--------X---------------------------------------XX|X-------------?????|-XXX-----------------|------------------------------------------??????-----------|--f-
-------T|-|--------|--------------------?--|----X--XX--------------------------------------XXX|X------------------|XXXX----X------------|---------------M-------------------------------------------|--f-
m------||-|--------|XXXXXE----E-----EE-----|----XXXXX----------------E--------------------XXXX|X------------------|XXXX---XX------------|-----------------------------------------------------------|E-X-
XXXXXXX||X|XXXXXXXX|XXXXXXXXXX-------XXXXXo|XXX-XXXXXXXXXXXXXXXXXXXXXXXXXXXXXXXXXXXXXXXXXXXXXX|XXXXXXXXXXXXXXXXXXX|XXXXXXXXX--------XXXX|XXXXXXXXXXXXXXXXXXXXXXXXXXXXXXXXXXXXXXXXXXXXXXXXXXXXX------|-XX-
