--------------------------B------------------------------------------------------------------------------------------------------------------------------------------------------------------------------
---------------------------------------------------------------------------------------------------------------------B-----------------------------------------------------------------------------------
------------------------------------------------------------------------------------------------------------------------------X--------------------------------------------------------------------------
-------------------------------------------------------???-------------------------------------X-----------------------M---------------------------------------------------------------------------------
----------------------------------------------------------------------o------------------------------------????---------------------------------------------------------------------------B-------?------
-----------------X---------------------------------o-------------------------------------------------------------------------------------???????---------------------------------------------------------
----------------XX---B----------------------------------????-------------------------???????-------------------------------------------------------------------------------------------------------------
---------------XXX-----------------------------------------------------X-------------X-----------------------------------------------------------------------B-----------------------------------------v-
-X------------XXXX----------------------------------B-------------------------------XX-----------------------------BBB-------------------------------------------------------------------------------B-f-
-T-----------XXXXX------------------------------B-----------------M----------------XXX-----------------------------------------------------------------------------------------------------------------f-
-|----------XXXXXX----------------------------------------------------------------XXXX---o-----------XXXXXXXX----------o-------------------------------------------------------------------------------f-
-|---------XXXXXXX-M-------------------------------------------------------------XXXXX---?---------------------------------------T---------------------------T-----------------------------------------f-
-|--------XXXXXXXX--------------------T-------------------X---------------------XXXXXX-----------???-----------------------------|--------------------T------|-----------------------------------------f-
-|-------XXXXXXXXX--------------------|-----X----------------------------------XXXXXXX--o----------------------------------------|--------------------|------|-----------------------------------------f-
m|---E--XXXXXXXXXX--------------------|-----XX------E---------E---------------XXXXXXXX-------o----E----------------------EE------|---------E-E--------|--E--E|---E-------------------------------------X-
X|XXX?XXXXXXXXXXXXXXXXXXXXXXXXXXXXXXXX|XXXXXXXX---------XXXXXXXXXXXXX-XXXXXXXXXXXXXXXXXXXXXXX----XXXXXXXXXXXXXXXXXX--XXXXXXXXXXXX|XXX---XXXXXXXXMXXX-X|XX----|-XXXXXXXXXXXXXXX----XX--XXXXXXXXXXXXXXXXXX-
