---X-------------------B----------------------------------------------------------------------------------------------------BBBBBBBB---------------------------------------------------------------------
--------------------------------------------------------------------------------X---------------------------------------M--------------------------------------------------------------------------------
----o----------------------------------------------------------------------------------------------------------------------------------------------------------------------------------------------------
---------------------------------------------------------------------------------------------------------------------------------------------X-----------------------------------------------------------
-----------------------------B----------M----------------------------------------------------------B-----------------------------------------------------------------------------------------------------
---------------------------------------------------------------------------------------------------------------------------------------------------------------------------------------------------------
----------------------------------------------------------------------------------------------------------------B----------------------------------------------------------------------???---------------
----------------------------------------------------------------------X------------------------o-------------------------------------------------------------B-----------------------------------------v-
-------------X-------------------------------------BBBB------------------------------------------------------------------------------------------------------X--------o--------------------------------f-
-----------------o-------------------------------------------------------------------------------------------------------------------------XXX------------------------------------------------------o--f-
-------------------------------------------------------------------------------------------------------------------------------------------------------------------------------------------------------f-
---------------B---------------M------------T-----------------------------------------------B--------X-----------------------------------------------------------X-----------------------------X-------f-
--------------------------------------------|-------------------------------------------------------XX------------------------?----------------------------------XX----------------------------XX------f-
---------o---------------------M------------|----------------------o-------------------------------XXX-----------B-----------------------------------------------XXXBB-------------------------XXX-----f-
m--X------E------------E-------E----------E-|----------------------------------E------------------XXXX-----------------------------------E-----------------------XXXX--------E-----------------XXXX----X-
XXXXXXXXXXXXXXXXXXXXXXXXXXXXXXXXXXXXX-XXXXXX|XXXXXXXXXX-----XXXXXXXXXXXXXXXXXXXXXXXXXXXXXXXXXX---XXXXXXXXXXXXXXXXXXXXXXXXXXXXXXXXXXXXXXXXXXXXXXXXXXXXXXXXXXXXXXXXXXXXXXXXXXXXXXXXXXXXXXXXXXXXXXXXXXXX--X-
