-----------------------------------------------------------------------------------------------------XXXXXX----------------------------------------------------------------------------------------------
------------------------------------------------------------------X---------BBBBB------------------------------------------------------------------------------------------------------------------------
---------------------------------------------------------------------------------------------------------------------------------------------------------------------------------------------------o-----
---------------------------------------------------------------------------------------------------------------------------------------------X----X-----------------B------------------------------------
-B----------------XXXXX-----------------------------------------------B---------------????????-----------B-----------------------XX--------------------------X----------------------------B--------------
----------------------------------------------------------------------------------------------------?---------------------------------------------------------------------------X------------------------
----------------------------------------T------------X---------------------------------------------------------------------------------------------------------------------------------???---------------
----------------------------------------|-----------------X----------------------------BBBB------------------------------------------------------------------B-----------------------------------------v-
--------------------T--------X----------|----------------XX-------------------------------------------B-----------------------------------------?----------------------------------------------------B-f-
------------T-------|-------XX----------|---------------XXX-------------------------------------------------------------------------------------------o----------------------T------------X------------f-
------------|-------|------XXX--------T-|---------o----XXXX-----------X------------------o------------------------------------------------------------------------------XXX--|-----------XX------------f-
------------|X------|-----XXXX--------|-|-------------XXXXX----------XX---------------------------------------------------------------------------------------T--------------|----------XXX------------f-
------------|X------|----XXXXX--------|-|------------XXXXXX---------XXX--------------------------???---------????-------------?-T-----------------------------|--------------|---------XXXX------------f-
-----------X|X------|---XXXXXX--------|-|-----------XXXXXXX-o--o---XXXX---------------------------------------------------------|-----------------------------|--------------|--------XXXXX-----------Tf-
m---------XX|X------|--XXXXXXX--------|-|----------XXXXXXXX-------XXXXX----------------E-------------------------E-------E------|------X-E-E-----E------------|--B-----------|-------XXXXXXX------E---|X-
XXXXXXXX-XXX|XXXXXX-|-XXXXXXXX----XXX-|X|-------XXXXXXXXXXXXXXXXXXXXXXXXXXXXXXXX---XXXXXXXXXXXXXXXXXXXXXXXXXXXXXXXX--X--------XX|XXXX---XXXXXXXXXXXX-XXXXXXXXX|XXXXXX--------|----X-XXXXXXXXXXXXXXXXXX|X-
