---------------------------------------------------------------------------------------------------------------------------------------------------------------------------------------------------------
----------------------------------------------------------------XX-------------------------------------------------------------------------------------------------------------o-------------------------
---------------------------------------------------------------------------------------------------------------------------------------------------------------------------------------------------------
------------------------------------------------------------------------------------B----------------------------------------XXXXXXXX--------------------------------------------------------------------
-------------------------------------------------------X----------------------------------------------------------------o------------------------------------------X-----------------------B-------------
------------------------------------------------------XX----------------------??-----------------------------------X----------------------------------------------XX-------------------------------------
---------------------------------------o-------------XXX--------------o------------------------------------------------------------------------------------------XXX-------------------------------------
----------------------------------------------------XXXX-----------------------------------------------------------------------------------X--------------------XXXXo--o-------------------------------v-
---------------BB----------------------------------XXXXX-----T----------????????------------B------------------------------------------------------------------XXXXX-----------------------------------f-
--------------------------------------------------XXXXXX-----|-------------------------------------------B----------------------------------------------------XXXXXX-----------------------------------f-
-------------------------------------------------XXXXXXX-----|----------------------XXXXX-----X--------------------------------------------------------------XXXXXXX---X--------X----------------------f-
-???--------------------------------------------XXXXXXXX-----|---------X---------------------------------------X---------------------------------M----------XXXXXXXX---------?-------------------------f-
--------BBBB-----------------------------------XXXXXXXXX-----|--------XX-------------?----------------------------------X----------------------------------XXXXXXXTX-----------------?-----------------f-
--------------------------------------------X-XXXXXXXXXX-----|-------XXX------------------------------------------------XX--------------------------------XXXXXXXX|X-----------------------------T-----f-
m---------------------------------------?---XXXXXXXXXXXX-----|------XXXX----E-----E------------------E------------------XXX------------------------------XXXXXXXXX|X---------E------?------------|-----X-
XXXXXXXXXXXXXXXXXXX---XXXXXXXXXXXX-----XXXXXXXXXXXXXXXXXXXXXX|XXXXXXXXXXXXXXXXXXXXXXXXXXX-----XXXX--XXXXXXXXXXXXXXXXXXXXXXXXXXXXXXXXXXXXXXXXXXXXXXXXXXXXXXXXXXXXXX|X--XXXXXXXXXXXXXXXXXXXXXXXXXXX|XXXXXX-
