--------------M-----------B--------------------------------------------------------------------------XXXXXX----------------------------------------------------------------------------------------------
----------------------------------------------------------------------------BBBBB------------------------------------------------------------------------------------------------------------------------
---------------------------------------------------------------------M-----------------------------------------------------------------------------------------------------------------------------o-----
---------------------------------------B-----------------------------X----------------------------------------------------------------------------X------------------------------------------------------
----------------------------------------------------------------------B---------------????????-----------B-----------------------XX--------------------------Xo------------------------------------------
----------o-----------------------------------------------------------------------------------------?---------------------------------------------------------------------------X------------------------
-----------------------------------------------------X---------------------------------------------------------------------------------------------------------------------------------------------------
---------------------------------------------------------------------------------------BBBB-----------------------?-------------------------B----------------------------------------------------------v-
--------------------------------------???-----------B-------------------------------------------------B-----------------------------------------?------------------------------------------------------f-
----------------------------------------o----------------------------------------------------------------------T--------------------------------------o----------------------T------------X------------f-
-------X------------------------------------------o---------X----------------------------o---------------------|--------------------------------------------------------XXX--|-----------XX------------f-
------XX---------------------------------------------------XX--------------------------------------------------|----------------------------------------------T-----X--------|----------XXX------------f-
-----XXX------------------------------T---------T---------XXXB-----------------------------------???---------??|?---------------T-----------------------------|--------------|---------XXXX------------f-
----XXXX------------------------------|---------|--------XXXX--o---------------------T-------------------------|----------------|-----------------------------|--------------|--------XXXXX-----------Tf-
m--XXXXX-------E-------------XE--E----|-------E-|-E-----XXXXX------------------------|-E-----------------------|-E--------------|------X-E-E----------E-------|--B-----------|-------XXXXXX-------E---|X-
XXXXXXXX--------XXXXXXXXXXXXXXXXXXXXXX|XXXXXXXXX|XXXXXXXXXXXXXXXXXXXXX-XXXXXXXXX---XX|XXXXXXXXXXXXXXXXXXXXXXXXX|XXX--X--------XX|XXXX---XXXXXXXXXXXX-------XXX|XXXXXX--------|----XXXXXXXXXXXXXXXXXXXX|X-
