--------------M-----------B----------------------------------------------------------------------o-------------------------------------------------------------------------------------------------------
---------------------------------------------------------------------------------------------------------------------------------------------------------------------------------------------------------
---------------------------------------------------------------------M--------------------------------------------------------X--------------------------------------------------------------------o-----
---------------------------------------B---------------???-----------X-----------------------------------------------------------------------------------------------------------------o-----------------
----------------------------------------------------------------------B----------------------------------------------------M????????----------------????-----X----------------------------B--------------
----------------------------------------------------------------------------------------------------?------------------------------------???????-o-------------------------------------------------------
-----------------------------------------------------X--????-------------------------???????-------------------------------------------------------------------------------------------------------------
-----------------------------------------------------------------------X-------------X----------------------------?-------------------------B---------------?------------------------------------------v-
--------------------------------------???-----------B-------------------------------XX----------------B-----------------------------------------?----------------------------------------------------B-f-
---------------------X------------------o-------B----------------------------------XXX--o----------------------T--------------------------------------o----X-----------------T-------------------------f-
--------------------XX--------------------------------------X---------------------XXXX---o---------------------|--------------------------------------------------------XXX-o|-------------------------f-
-------------------XXX-------------------------------------XX--------------------XXXXX-------------------------|----------------------------------------------T-----X--------|-------------------------f-
------------------XXXX----------------T-------------------XXXB------------------XXXXXX-----------???---------??|?-------X-------------------------------------|--------------|-------------------------f-
-----------------XXXXX----o-----------|------------------XXXX--o---------------XXXXXXT--o-------T--------------|--------XX------------------------------------|--------------|-------------------------f-
m-----o---------XXXXXX-------XE-EE----|-------E---E-E---XXXXX-----------------XXXXXXX|-------o--|--------------|-E------XXX-------------M--E----------E--E----|--E-----------|-------------------------X-
XXXXXXXX-------XXXXXXXXXXXXXXXXXXXXXXX|XXXXXX---X------XXXXXXXXXXXXXX-XX----XXXXXXXXX|-XXXXXX---|XXXXXXXXXXXXXX|XXX--X--XXXX--XXXXXXX---XXXXXXXXXXXX-------XXX|XXXXXXXXXXXXXX|-----------XXXXXXXXXXXXXXX-
