---------------------------------------------------------------------------------------------------------------------------------------------------------------------------------------------------------
--------------------------------------------------------------------------------------------------------------------------------------------------------------X---B--------------------------------------
------------o----o----------------------------------------------------------------------------------BBBBBBB--------------------------------------------?----------------------M--------------------------
------M----------------------------------------------------------------------------------------------o------------BBBBB---------------BB-----------------------------------------------------------------
-------------------BBBBB---------XX-----------------BBBBBBB------------------B----------------------------------------------------------------------------------------------???--------------------------
---------------------------------------------------------------------------------------------------------------BBB--------------------------------------------------------------o------------------------
------------------------------------------------B---------BBBB----------------------T--------------------------------------------------?-----------------X------X-----------BB---?--------BBBBBBB--------
--------------------------------?---------------------------------------------------|---------------------------------------------------X--B-------------XX-----XX----------------------------------T--v-
-------------------------o----B-----------------------------------------------------|--------------B-------B--------------------?-------------------??---XXX----XXX-------------------X-------------|--f-
------M------------????????-----------??-------------------?------------------------|--------------------------------------------------------------------XXXX---XXXX--------------------------------|--f-
-----------------------T-------------------------------------------------------T----|----------------------------------------------M-------------------B-XXXXX--XXXXX-------------------------------|--f-
-----------------------|------------------------------------------------------B|----|-------------------------o----------------o-------------------------XXXXXX-XXXXXX---------------------o--------|--f-
------------------B----|------------------------B------?-----------------------|----|-------?-----------------------------------------------------T------XXXXXXXXXXXXXX------------??????-----------|--f-
-----------------------|--------------------X----------------------------------|----|----------------------------------------??-----------------o-|------XXXXXXXXXXXXXXX----------------------------|--f-
m---------------------E|-X----------------E--------------------------E-X-------|E---|----------E-----------E-----------------????????-------------|------XXXXXXXXXXXXXXXX-----E------E--------?????-|E-X-
XXXXXXXXXXXXXXXXXXXXXXX|XXXXXXXXXXXXXXXX------XXXXXX---XMX-----XX-XXXXXXXXXXXX-|----|-XXXX----XXXXX------XX-------XXXXXXXXXXXX-------------XXXXXXX|XXXXXXXXXXXXXXXXXXXXXXXXXXXXXXXXXXXXXXXX-XXXXXXXX|--X-
