--------------M----------------------------------------------------------------------------------o------------------X------------------------------------------------------------------------------------
---------------------------------------------------------------------------------------------------------------------------------------------------------------------------------------------------------
---------------------------------------------------------------------------------------------------------------------------------------------------------------------------------------------------------
---------------------------------------B-----------------------------------------------------------------------------------------------------------------------------------------------o-----------------
----------------------------------------M----------------------------------------------------------------------------------M????????----------------????-------------------------------------------------
----------o-------------------------------?----------------------------------------------o-------------------------------------------------------o-------------------------------------------------------
--------------------------------------------------------????-------------------------???????-------------------------------?????-------------------------------------------------------------------------
----------------------------------------------------------------------X--X-----------X---------o------------------------------------------------------------?------------------------------------------v-
--------------------------------------???----------BBBB-----------------------------XX-----------------------------------------------------------------------------------------------------------------f-
-----------------------------------------------------------------------------------XXX--o------------------------------------------------------------------X-------------------------------------------f-
-------X----------------------------------------------------X---------------------XXXX------------------BBBBB---------------------------------------------------------------o--------------------------f-
------XX----------------------------------X-T--------------XX--------------------XXXXX-----------------------------------------------------------------------------------------------------------------f-
-----XXX------------------------------------|---T---------XXX-------------------XXXXXX----------------------------------X-----------------------------------------T------------------------------------f-
----XXXX-----------------------M------------|---|--------XXTX-----?----T---M---XXXXXXX--o-------T-------------X---------XX----------------------------------------|------------------------------------f-
m--XXXXX-------E-------------XE--E----------|---|---E---XXX|X---E---E--|----E-XXXXXXXX----------|---------E-------------XXX-------------M---E---------------------|----------o-------?--E--------------X-
XXXXXXXXXXXXXXXXXXXXXXXXXXXXXXXXXXXXX-XXXXXX|XXX|XXXXXXXXXX|XXXXXXXXX-X|XXXXXXXXXXXXXX-XXXXXXXXX|XXXXXXXXXXX-----XXXXXXXXXXXXXXXXXXXXXXXXXXXXXXXXXXXBXXXXXXXXXXXXX|XXXXXXXX-------XXXXXXXXXXXXXXXXXXXXXX-
