-------------------------------------------------------------------------------------------------o-------------------------------------------------------------------------------------------------------
---------------------------------------------------------------------------------------------------------------------------------------------------------------------------------------------------------
------------o---------------------------------------------------------------------------------------BBBBBBB--------------------------------------------------------------o----------------------------B--
-----------------------------------------------------------------------------------------------------------M---------------------------------------------------------------------------------------------
-------------------BBBBB---------XX-----------------BBBBBBB------------------B----------------------B---------------------------------------------------------------------?------------------------------
---------------------------------------------------------------------------------------------X------------------------------------B----------------------------------------------------------------------
------------------------------------------------B-------------------------------B---T-------XX-----------------------------------------------------------------------------------?-----------------------
--M-----------------------------?---------------------------------------------------|------XXX-----------T---------------------------------------------------------------------------------------------v-
------------------------------B-----------------------------------------------------|-----XXXX-----------|-B-----------------------------------B-------------------------------------------------------f-
------M-----------------------------------------------------------------------------|----XXXXX?----------|-----------X------------?-------------?-----------------------------------------------X------f-
-----------------------T-------------------------------------------------------T----|-XXXXXXXX-----------|----------------------------------XXX------------------------------------------------XX---T--f-
-----------------------|------------------------------------------------------B|----|--XXXXXXX-----------|------------------------------------------------------------------------------------XXX---|--f-
------------------B----|------------------------B-----------------------------o|----|-XXXXXXXX-----------|-------------------------?------o---------------------------M----------------------XXXX---|--f-
-----------------------|-------------------------------------------------------|----|XXXXXXXXX-----------|------------------------------------------------------------------T---------------XXXXX---|--f-
m---------------------E|-X-------------------------------------------E---------|----|XXXXXXXXX-E-----X---|-E----------E-------------------E---------------------------------|--------------XXXXXX---|--X-
XXXXXXXXXXXXXXXXXXXXXXX|XXXXXXXXXXXXXXXX------XXX------XXXXXXXXXX-XXXXXXXXXXXXX|XXXX|XXXXXXXXXXXXXXXXXXXX|X------XXXXXXXXXXXXXXXX----XXXX-------XXXXXXXXXXXXXX------XXXXXXXX|X---XXXXXXXXXXXXXXXX---|--X-
