-M-----------------------------------------------------------------------------------------------------------------------------------------------------------------------------------------------X-------
---------------------------------------------------------------------------------------------------------------------------------------------------------------------------------------------------------
---------------------------------------------------------------------------------------------------------------------------------------------------------------------------------------------------------
-------------------------------------------------B--------------------------------------------------------------------B----------------------------------------------------------------------------------
---------------------------------------------------------------------------------------------------------------------------------------------------------------------------------------------------------
---------------------------------------------------------------------------------------------o-----------------------------------------------------------------------------------------------------------
------------------------------------------------------------------------XXXXX----------------------------------------------------------------------------------------------------------------------------
-------------------------------------------------------------------------------------------------------------------------------------------------------------------------------------------------------v-
-------------------------------------------------------------------------------------------------------------------------------------------------------------------------------------------------------f-
-------------------------------------------------------------------------------------------------X-----------------------------------------------------------------------------------------------------f-
------------------------------------------------------------------------------------------------XX-----------------------------------------------------------------------------------------------------f-
------------------M----------------------------------------------------------------------------XXX---------------------------------------------------------------------------------------------------T-f-
----------------------------X-----------------------------------------------------------------XXXX---------------------------------------------------------------------------------------------------|-f-
---------------------------------------------------------------------------------------------XXXXX---------------------------------------------------------------------------------------------------|-f-
m------------------------------------------------------X-----------------E------------------XXXXXX---------------------------------------------------------------------------------------------------|-X-
XXXXXXXXXXXXXXXXXXXXXXXXXXXXXXXXXXXXXXXXXXXXXXXXXXXXXXXXXXXXXXXXXXXXXXXXXXXXXXXXXXXXXXXXXXXXXXXXXXXXXXXXXXXXXXXXXXXXXXXXXXXXXXXXXXXXXXXXXXXXXXXXXXXXXXXXXXXXXXXXXXXXXXXXXXXXXXXXXXXXBBXXXXXXXXXXXXXXX|XX-
