---------------------------------------------------------------------------------------------------------M------------------------------------------------------------------------XXXXXXXX---------------
---------------------------------------------------------------------------------------------------------------------X-----------------------------------------------------------------------------------
------------o---------------------------------------------------------------------------------------BBBBBBB--------------------------------------------------------------o----------------------------B--
-----------------------------------------------------------------------------------------------------------M------BBBBB----------------------------------------------------------------------------------
-------------------BBBBB---------XXo----------------BBBBBBB------------------B----------------------B---------------------------------------------------------------------?------------------------------
---------------------------------------------------------------------------------------------X------------------------------------Bo---------------------------------------------------------------------
------------------------------------------------B----------------------------B--B---T-------XX---------------------------------------o-------------------------------------------------------------------
--M-----------------------------?---------------------------------------------------|------XXX---------------------------------------------------------------------------------------------------------v-
------------------------------B-----------------------------------------------------|--M--XXXX-----B-------B-------------------------------------------------------------------------------------------f-
------M-------------------------------??-------------------?------------------------|----XXXXX-----------------------X------------?-----------o-------------------------------------------------X------f-
-----------------------T-------------------------------------------------------T----|---XXXXXX----------------------------------------------XXX------------------------------------------------XX---T--f-
-----------------------|------------------------------------------------------B|----|--XXXXXXX----------------o------------o------------------------------------------------------------------XXX---|--f-
------------------B----|------------------------B------?-----------------------|----|-XXXXXXXX-------------------------------------?------o---------------------------M----------------------XXXX---|--f-
-----------------------|--------------------X---------------------------------?|----|XXXXXXXXX----------------------BBBBBB--------------------------------------------------T---------------XXXXX---|--f-
m---------------------E|-X-------------------------------------------E-X-----E-|E---|XXXXXXXXX-E-----X-----E----------E-------------E--------E-E----------------------------|--------------XXXXXX---|--X-
XXXXXXXXXXXXXXXXXXXXXXX|XXXXXXXXXXXXXXXX------XXXXXX---XXXXXXX------XXXXXXXXXXX|XXXX|XXXXXXXXXXXXXXXXXXXXXX------XXXXXXXXXXXXXXXX----XXXXXXXXXXXXXXXXXXXXXXXXXXXXXXXXXXXXXX-|---XXXXXXXXXXXXXXXXX---|--X-
