-------------------------------------------------------------------------------------------------------------------------------------M-----------------------B------------------M------------------------
---------------------------------------------------------------------------------------------------------------------------------------------------------------------------------------------------------
------------o---------------------------------------------------------------------------------------BBBBBBB----------------------------------------------------------------------------------------------
-------------------------------------------------------------------------------------------------BBBBo-------------------------------------------M-------------------------------------------------------
-------------------BBBBB---------XX-----------------BBBBBBB------------------B----------------------------------X----------------------------------------------------------------------------------------
--------------------------------------------------------------------------------------------------------------B-------------------------?---------------------------------------o------------------------
------------------------------------------------B-----------------------------------T-------------------------------X------------------------------------------------------------?--------BBBBBBB--------
--M-----------------------------?---------------------------------------------------|------------------------------XX-------------------------------------------------------------------------------T--v-
------------------------------B------------------------------------?----------------|--------------B--------------XXX-----------------M-----------------------------------------------X-------------|--f-
------M-----------------------------------------------------------------------------|----------------------------XXXX-------------------------------------------------------------------------------|--f-
-----------------------T-------------------------------------------------------T----|---------------------------XXXXX---------------------------------------------?---------------------------------|--f-
-----------------------|------------------------------------------------------B|----|-------------------------oXXXXXX----------------------------------------------------------------------o--------|--f-
------------------B----|------------------------B------------------------------|----|-------------------------XXXXXXX--------------------------------------------------------------??????-----------|--f-
-----------------------|-------------------------------------------------------|----|------------------------XXXXXXXX-----------------------------------M---------------------------------?---------|--f-
m---------------------E|-X---------------------------------E---------E--------X|E---|----------E-----------EXXXXXXXXX-----------------------E---------------------------------------------------E---|E-X-
XXXXXXXXXXXXXXXXXXXXXXX|XXXXXXXXXXXXXXXX------XXXXXX---XXXXXXXXXX-XXXXXXXXXXXXX|XXXX|XXXXX----XXXXXXXXXXXXXXXXXXXXXXXXXXXXXXXXXXXXXXXXXX--------XXXXXXXXXXXXXXXXXXXXXXXXXXXXXXXXXXXXXXXXXXXXXX------|-XX-
