---------------------------------------------------------------------------------------------------------------------------------------------------------------------------------------------------------
--------------------------------------------------------------------------------------------------------------------------------------------------------------X---B--------------------------------------
----------------------------------------------------------------------------------------------------BBBBBBB--------------------------------------------?----------------------M--------------------------
-----------------------------------------------------------------------------------------------------o--------------------------------BB-----------------------------------------------------------------
-------------------BBBBB---------XX-----------------BBBBXBB------------------B--------------------------------------------------------------------------------------------------------------------o------
---------------------------------------------------------------------------------------------------------------BBB--------------------------------------------------------------o------------------------
------------------------------------------------B-----------------------------------T--------------------------------------------------?-----------------X------X-----------BB------------BBBBBBB--------
--------------------------------?---o-----------------------------------------------|---------------------------------------------------X----------------XX-----XX----------------------------------T--v-
------------------M-----------B-----------------------------------------------------|--------------B-------B----------------------------------------??---XXX----XXX-------------------X-------------|--f-
--------------------------------------??------------X------?------------------------|--------------------------------------------------------------------XXXX---XXXX--------------------------------|--f-
-----------------------T---------------------------XX--------------------------T----|------X---------------------------------------M-------------------B-XXXXX--XXXXX-------------------------------|--f-
-----------------------|--------------------------XXX---------------------?---B|----|---X---------------------o----------------o-------------------------XXXXXX-XXXXXX---------------------o--------|--f-
------------------B----|------------------------BXXXX--?-----------------------|----|-------------------------------------------------------------T------XXXXXXXXXXXXXX------------??????-----------|--f-
-----------------------|--------------------X---XXXXX--------------------------|----|-------------------------------------------------------------|------XXXXXXXXXXXXXXX----------------------------|--f-
m---------------------E|-X-------------------E-XXXXXX------E----E----E-X-------|E---|----------E-----------E-------o------------------------------|------XXXXXXXXXXXXXXXX------------E--------?????-|E-X-
XXXXXXXXXBXXXXXXXXXXXXX|XXXXXXXXXXXXXXXX------XXXXXXX--XMXXXXX------XXXXXXXXXXX|XXXX|XXXXX----XXXXXXXXXXXXXXX----XXXXXXXXXXXXXXXXXXXXXXXXXXXXXXXXX|X---XXXXXXXXXXXXXXXXXXXXXXXXX-XXXXX-------XXXXXXX|--X-
