---------------------------------------------------------------------------------?-----------------------------------------------------------------------------------------------------------------------
---------------------------------------------------------------------------------------------------------------------------------------------------------------------------------------------------------
---------------------------------------------------------------------------------------------------------------------------------------------------------------------------------------------------------
------------------------------------------------------------------------------------B----------------------------------------XXXXXXXX--------------------------------------------------------------------
---------------------------------------------------------------------------------------------------------------------------------------------------------------------------------------------------------
-------------------------------------------------------------------------------------------------------------------X-------------------------------------------------------------------------------------
--------------------------------------------B-------------------------o-----T---------------------------------------------------------------------------------------------------X------------------------
-------------------------------------------o--------------------------------|--------------------------------------------------------------X------------------------o----------------------------------v-
---------------BB-------------------------------------------------------????|???------------B--------------------------B-------------------------------------------------------------------------------f-
----------------------------------------------------------------------------|----------------------------B---------------------------------------------------------------------------------------------f-
----------------------------------------------------------------------------|-------XXXXX-----X-----------------X---------------------------------------------------------------X----------------------f-
-???--------------------------------------------------X--XB------------X----|----------------------------------XX--------B-----------------------M-----------------------------------------------------f-
--------BBBB----------------------------------------------------------XX----|--------?------------------------XXX-------------------------------------------------T------------------?-----------------f-
--------------------------------------------X------------------------XXX----|--------------------------------XXXX-----------B-------------------------------------|------------------------------T-----f-
m---------------------------------------?---XX----------------------XXXX----|------------------------E------XXXXX-------------------------------------------------|-----------------?------------|-----X-
XXXXXXXXXXXXXXXXXXX---XXXXXXXXXXXX-----XXXXXXXXX-XXXXXXXXXXXXXXXXXXXXXXXXXXX|XXXXXXXXXXXXXXXXXXXXXXXXXXXXXXXXXXXXXXXXXXXXXXXXXXXXXXXXXXXXXXXXXXXXXXXXXXXXXXX-XXXXX|XXXXXXXXXX----XXXXXXXXXXXXXXXX|XXXXXX-
