-------------------------------------------------------------------------------------------------o-------------------------------------------------------------------------------------------------------
---------------------------------------------------------------------------------------------------------------------X-----------------------------------------------------------------------------------
------------o---------------------------------------------------------------------------------------BBBBBBB--------------------------------------------------------------o----------------------------B--
-----------------------------------------------------------------------------------------------------------M------BBBBB----------------------------------------------------------------------------------
-------------------BBBBB---------XX-----------------BBBBBBB------------------B----------------------B----------------------------------------------------------------------------------------------------
---------------------------------------------------------------------------------------------X------------------------------------Bo---------------------------------------------------------------------
------------------------------------------------B-----------------------------------T-------XX-----------------------------------------------------X-----------------------------?-----------------------
--M-----------------------------?---------------------------------------------------|------XXX-----------T------------------B--------------------------------------------------------------------------v-
------------------------------B-----------------------------------------------------|-----XXXX-----------|-B-------------------------------------------------------------------------------------------f-
------M-----------------------------------------------------------------------------|----XXXXX-----------|------------------------?-------------------------------------------------------------X------f-
-----------------------T-------------------------------------------------------T----|-XXXXXXXX-----------|------------X---------------------XXX------------------------------------------------XX---T--f-
-----------------------|------------------------------------------------------B|----|--XXXXXXX-----------|----o----??XX?----------------------------------------------------------------------XXX---|--f-
------------------B----|------------------------B------------------------------|----|-XXXXXXXX-----------|----------XXX------------?------o---------------------------M----------------------XXXX---|--f-
-----------------------|-------------------------------------------------------|----|XXXXXXXXX-----------|---------XXXX-----------------------------------------------------T---------------XXXXX---|--f-
m---------------------E|-X-------------------------------------------E---------|E---|XXXXXXXXX-E-----X---|-E------XXXXX--------------------------------E-----------------E--|--------------XXXXXX---|--X-
XXXXXXXXXXXXXXXXXXXXXXX|XXXXXXXXXXXXXXXX------XXX------XXXXXXXXXX-XXXXXXXXXXXXX|XXXX|XXXXXXXXXXXXXXXXXXXX|X------XXXXXXXXXXXXXXXXXXXXXXXXXXXXXXXXXXXXXXXXXXXXXXXXXXXXXXXXXXX|XXXXXXXXXXXXXXXXXXXX---|--X-
