---------------------------------------------------------------------------------------------------------------------------------------------------------------------------------------------------------
----------------------M----------------------------------------------------------------------------------------------------------------------------------------------------------------------------------
------------------------------------------------------------------------------------------B--------------------------------------------------------------------------------------------------------------
---------------------------------------------------------------------------???---------------------------------------------------------------------------------------------------------------------------
------------------------------------------------------------------------------------------------X--------------------------------------------------------------------------------------------------------
-----------------------------------------------------------------------------------------------------------------------------------------------------------???-------------------------------------------
---------------------------------------------------------------------------------------------------------------------------------------------------------------------------------------------------------
--------------------------------------------------------------------------------------------------------------------X---------------------------------------------------------------------------o------v-
-------------------------------------------------------------------------------------------------------------------------------------------------------------------------------------------------------f-
-------------------------------------------------------------------------------------------------------------------------------------------------------------------------------------------------------f-
-------------------------------------------------------------------------------------------------------------------------------------------------------------------------------------------------------f-
-------------------------------------------------------------------------------------------------------------------------------------------------T-----------------------------------------------------f-
-------B-----------------------------------------------------------------------------------------------------------------------------------------|-----------------------------------------------------f-
------------------------------------------M------------------------------------------------------------------------------------------------------|-----------------------------------------------------f-
m------?--------------------------------------------------------------------------------E--?-----------------------------------------------------|-----------------------------------------------------X-
XXXXXXXXXXXXXXXXXXXXXXXXXXXXXXXXXXXXXXXXXXXXXXXXXXXXXXXXXXXXXXXXXXXXXXXXXXXXXXXXXXXXXXXXXXXXXXXXXXXXXXXXXXXXXXXXXXXXXXXXXXXXXXXXXXXXXXXXBXXXXXXXX|XXXXXXXXXXXX-XXXXXXXXXXXXXXXXXXXXXXXXXXXXXXXXXXX-----X-
