----------------------------------XXXXXX---------------------------------------XXXXXXXX------------------------------------------------------------------------------------------------------------------
---------------------------------------------------------------------------------------------------------------------------------------------------------------------------------------------------------
---------------------------------------------------------------------------------------------------------------------------------------------------------------------------------------------------------
-------------o-------------------------------------------------------------------------------------------------------------------------------------------------------------------------------------------
---------------------------------------------------------------------------------------------------------------------------------------------------------------------------------------------------------
----------------X----------------------------------------------------------------------------------------------------------------------------------------------------------------------------------------
---------------XX----------------------------------------------------------------------------------------------------------------------------------------------------------------------------------------
--------------XXX----------------------------------------------------------------------------------------------------------------------BBBBBB----------------------------------------------------------v-
-------------XXXX--------------------------------------------------------------------------------------------------------------------------------------------------------------------------------------f-
------------XXXXX-------------------------------------------------------------BBBBBBBB-----------------------------------------------------------------------------------------------------------------f-
-----o-----XXXXXX--------------------------------------------------------------------------------------------------------------------------------------------------------------------------------------f-
----------XXXXXXX-T------------------------------------------------------------------------------------------------------------------------------------------------------------------------------------f-
---------XXXXXXXX-|----B-------------------------------------B------------------o--------------------------------------------------------------------------------------B-------------------------------f-
--------XXXXXXXXX-|-------------------------------------------------------------------?----------------------------------------------------------------------------------------------------------------f-
m------XXXXXXXXXX-|--------------------E--------------------------------------------------E-----E-----------------------------------E------B-----------------------------------------------------------X-
XXXX--XXXXXXXXXXXX|XXXXXXXXXXXXXXXXXXXXXXXXXXXXXXXXXXXXXXXXXXXXXXXXXXXXXXXXXXXXXXXXXXXXXXXXXXXXXXXXXXXXXXXXXXXXXXXXXXXXXXXXX--------XXXXXXXXXXXXXXXXXXXXXXXXXXXXXXXXXXXXXXXXXXXXXXXXX--XXXXXXXXXXXXXXXXX-
