---------B-----------------------------------------------------------------------------------------------------------------------------------------------------------------------------------------------
---------------------------------------------------------------------------------------------------------------------------------------------------------------------------------------------------------
---------------------------------------------------------------------------------------------------------------------------------------------------------------------------------------------------------
-----------------------------------------------------M--------------------------------------------------------------------------------------------------------------------------------o------------------
---------------------------------------------------------------------------------------------------------------------------------------------------------------------------------------------------------
---------------------------------------------------------------------------------------------------------------------------------------------------------------------------------------------------------
---------------------------------------------------------------------------------------------------------------------------------------------------------------------------------------------------------
-------------------------------------------------------------------------------------------------------------------------------------------------------------------------------------------------------v-
--------------------------------------------?----------------------------------------------------------------------------------------------------------------------------------------------------------f-
----------------------------------------------------------------------o----X---------------------------------------------------------------------------------------------------------------------------f-
--------------------------------------------------------------------------XX--------------------------------M------------------------------------------------------------------------------------------f-
-------------------------------------------------------------------------XXX--------------------------------------------------------------------------T-----------------------M------------------------f-
------------------------------------------------------------------------XXXX--------------------------------------------------------------------------|------------------------------------------------f-
-------------M---------------------------------------------------------XXXXX--------------------------????--------------------------------------------|------------------------------------------------f-
m--------E------------------------------------------------------------XXXXXX----------------------B-----------------------E---------------E-----------|------------------------------------------------X-
XXXXXXXXXXXXXXXXXXXXXXXXXXXXXXX-------XXXXXXXXXXXXXXXXXXXXXXXXXXXXXXXXXXXXXXXXXXXXXXXXXXXXXXXXXXXX--------XXXXXXXXXXXXXXXXXXXXXXXXXXXXXXXXXXXXXXXXXXXX|XXXXXXXXXXXXXXXXXXXXXXXXXXXXXXXXXXXXXXXXXXXXXXXXX-
