---------------------------------------------------------------------------------------------------------------------------------------------------------------------------------------------------------
---------------------------------------------------------------------------------------------------------------------------------------------------------------------------------------------------------
-----------------------------BM----------------------------------------------------------------------------B----X---------o------------------------o-------------------------------------------------B---
---------o------o----------------------------------BMMM-----o---------------------------------MB--------------------X----o--------BBo----B-----------------B-----------------------B---------------------
----o---o-o-------------B--------------------------------------------------------------BM-----o--------------------------------B----------------o---------------------------?-----------------o----------
-------------B------?M----?M------?B---------------------M---o------M-B----------------oo---------------------------------------------------------------------B--------------B------------------B--------
----------------------------------------o-----------------------------------?-----------------------M---o--------------------------------------------------?B--------------------------------------------
----?-----?-----------X--------------o--------B----------o---------------------BB-----------------------------o----------?M--------------------------------------o------------------o---B----------?---v-
----------------------------B------------------------------------------?----------------BM-M--B----------------------------------------------------------------------------B------------------------BB-f-
----------------------------------B-----B---B----------------------------------------------o------o-------E--------------------------------------------------------------E-----------------------?-----f-
--------------------o------?-o--------o---------------Xoo-oo-----------------------oo--------------o------XXB-oo------BM-------o--X------o---B--------------M?---------o-BM----MB----o------o-?--------f-
------o-M---o--------X----o-oo------o---------M--?oo----o--------o-M-??oo----o-XM-o--------------o-----Xoo----oo-------o--??---------E--------o---------------oo-----------X---------oo----------o----of-
------T---------B--T-----T--T-------o----BB--oo--ooo-o-T--T---o-o-------o-o---o----TT-----------oo-----ooo----T-o-----o---o-------o--B-o------T-------B---------B--B----------o-oo-o-T------T------o---f-
------|------------|-----|--|-----------------o---T----|--|----TT------T-----------||-----------T------oT-----|-----------o------o---------o--|---------------T------------------o---|------|------o-T-f-
m-----|-----E-E----|-----|--|----------------T----|E---|--|----||------|-----------||------E----|-E---T-|-----|----------T-------T--------TE--|---------------|--------------E--T----|------|----E-T-|-X-
X---XX|XXXXXX-XXXXX|XXXXX|XX|-XXXXXXXXX----XX|XXXX|XXX-|XX|XX-X||XXXXXX|XXXXXXXXXXX||XXXXXXXXX-X|XXXX-|X|XX-XX|---XXXX-XX|XXXXXX-|XX-XXX-X|XXX|XXXXXXXXXXXXXXX|XXXXX-XXXXXX-XXXX|XXXX|X-XXXX|XXXXXX|X|-X-
