------------------------------------------o--------------------------------------------------------------------------------------------------------------------------------------------------------------
---------------------------------------------------------------------------------------------------------------------------------------------------------------------------------------------------------
---------------------------------------------------------------------------------------------------------------------------------------------------------------------------------------------------------
-------------------------------------------o-------------------------------------------------------------------------------------------------------------------------------------------------------------
----------------------------------------------------------------------------------X----------------------------------------------------------------------------------------------------------------------
-------------------o-------------------------------------------------------------XX----------------------------------------------------------------------------------------------------------------------
--------------------------------------------------------------------------------XXX----------------------------------------------------------------------------------------------------------------------
-------------------------------------------------------------------------------XXXX-------------------------------------------------?------------------------------------------------------------------v-
------------------------------------------------------------------------------XXXXX--------------------------------------------------------------------------------------------------------------------f-
-----------------------------------------------------------------------------XXXXXX-----------------------------------------------------------------------------X-------------X------------------------f-
-------------------------------------X--------------------------------------XXXXXXX-----------------------------------------------------X--------------------------------------------------------------f-
------------------------------------XX-------------------------------------XXXXXXXX----------------------------------------------------XX--------------------------------------?-----------------------f-
-----------------------------------XXX------------------------------------XXXXXXXXX---------------------------------------------------XXX-----------------------------------????-----------------------f-
----------------------------------XXXX-----------------------------------XXXXXXXXXX--------------------------------------------------XXXX---------------------------------X----------------------------f-
m---------------X----------------XXXXX------X----------------E----------XXXXXXXXXXX--------------------------?----------------------XXXXX--------------------------E-----------------------------------X-
XXXXXXXXXXXXXXXXXXXXXXXX--XXXXXXXXXXXX?XXXXXXXXXXXXXXXXXXXXXXXXXXXXXXXXXXXXXXXXXXXXXXXXXXXXXXXXXXXXXXXX?????------X-----XXXXXXXXXXXXXXXXXXXXXXXXXXXXXXXXXXXXXXXXXXXXXXXXXXXXXXXXXXXXXXXXXXXXXXXX-----XXX-
