---------------------------------------------------------------------------------------------------------------------------------------------------------------------------------------------------------
---------------------------------------------------------------------------------------------------------------------------------------------------------------------------------------------------------
--------------------------------------------------------B------------------------------------------------------------B-------------------------------------------B---------B-----------------X-----------
----B---------------------B--M--o-----------XMB-------X----M---------------------------B----------------M------------o-XBX------------------------o-------XB------BB----------o---------------------o----
-------XM---o-B-----------------------------------------------B----------------------M-o-----------------B-----B?---o---------------------?-------o------------------B---------------B-------------------
----------------------B?-------------------------------------------------B----o----?------B---B------------------X-----------------------o-----BX------------------------------------o---B---------------
--------------------o----------oMXB-----o----------------------------------------MBo-------------------o----------------------------------o--------------------B----------------X------------M-------M---
-----------o---------------------o--------B-BB?---------B--------o-----B-------------------------o----------------------------------------------------------------------o-------o----------------------v-
-----------------------------------------------B--M-----o---------------------------------------------------o-----------X--------------------------B----------------B------------o---------------------f-
---------------B-----------------------------------------------------------------------------------------------------B--------------------------------------------------------------B------------------f-
----------------B-B?M-X------M------------oo--------o--------?----------------------o--o--------------o---------------------------B---??oo----B--------XBX-----X-?B-------BM------------XBB-------?B---f-
-----------Mo---o---------------?BB----?M-o-XB-----o--------------BBX--o----BBM--M--oo--o-----o----------?o-o-----------------BMBB------oo-----?BMMX-------o----------------o-----------o---B----------f-
---------oo--o-----------BBB--T-----------T---BB---------------B-------o-----o-ooo--T--T---o--o------------oo---BB----------------------To-o-------------oo----------o-------o--BB--o--------BBo-o--o-of-
------------T--T--------------|-----------|---------oo-----------------T-------T----|--|------T-----------TT----------------------------|-----------------o------------------oo-----oo-----------T-----f-
m--------T--|--|--------------|-----------|------E--TE----E------------|-------|E---|--|------|--EE-------||----------------------------|----------------T-------------------T-E--TET------------|-----X-
X---XXXXX|XX|XX|XX-XXXXXXXXXXX|XXXXX---XXX|XXXXXXXXX|XXXXXXXXXXXXXXXXXX|-XXXXXX|XXXX|X-|XXXX-X|-XXXXXXXX-X||XXXXXXXXXXXXXXXXXXXXXXXXX-XX|XXXXXX-XXXXXXXXX|X-XXXXXXXXX-XXXXXXX|XX-X|X|XXXXXXXXXX-X|XXXXXX-
