-------------------------------------------o-------------------------------------------------------------------------------------------------------------------------------------------------------------
--------------------------------------------M-------------------------------------------------------------------------------------------------------????-------------------------------------------------
----------------------------------------------------------------------o----------------------------------------------------------------------------------------------------------------------------------
---------------------------------------------------------------------------------------------------------------------------------------------------------------------------------------------------------
--------------------------------------------------------------------------------B------------------------------------------------------------------------------------------------------------------------
-----------------------------------------------------------------------------------------------------------------------------o-------------------------o-------------------------------------------------
----------------------------------------------------------------------------------------------------------------------------------------------------------------------M----------------------------------
-----------------X-------------------------------------------BBBBB----------------------------------BB-------------------------------------------------------------------------------------------------v-
-----------------XX-----------------------------------------------------------------------------------------------------------------------------------------------------------------------------?------f-
----------------oXXX-----------------------------------------o-----------------------------------------------------------------------------------------------------------------------------------------f-
-----------------XXXX-------------------------------------------------------------------------------------------X--------------o-----------------------------------------------------------------------f-
-------------T---XXXXX-----------------------------------------------------------------------------------------XX------o-------------------------------------------------------------------------------f-
-------------|---XXXXXX---------------------------------------------------------------------------------------XXX---------------XXXXXXX----------------------------------------------------------------f-
-------------|---XXXXXXX--------------------------------------------------------????????---------------------XXXX--------------------------------------------------------------------------------------f-
m------------|---XXXXXXXX------------------------E-----E-------------E-----E--------------------------------XXXXX--------------------------------------------------------------------------------------X-
XXXXXXXXXXXXX|XXXXXXXXXXXXXXXXXXXXXXXXXXXXXXXXXXXXXXXXXXXXXXXXXXXXXXXXXXXXXXXXXXXXXXXXXXXXXXXXXXXX--XXXXXXXXXXXXX----XXXXXXXXXXXXXXXXXXXXXXXXXXXXXXXXXXXXXXXXXXXXXXXXXXXXXXXXXXXXXXXXXXXXXXXXXXXXXXXXXXX-
