----------------?---------------------------------------------------M------------------------------------------------------------------------------------------------------------------------------------
------------------------o----------------------?-------------------------------------------------------------------------------o-------------------B-----------------------------------------------------
---------------------------------------------------------------------------------------------------------------------------------------------------------------------------------------------------------
-----------------------------------------------------------------------------------------------------o-------M----------------------------------------------------------o--------------------------------
----------------------------------------------------------------------------X-------------------BBBBM--------------------------------------------???????-------------------------------------X-----------
-------------------------------------------------------------------------------------------------o------------------------------------o------------------------------------------------------------------
---------------------------------------------------------------------------------------------------------------------------------------------------------------------------------------------------------
---------------------------------------------------X-------------------------------------------------------------------------------------------------------------------------------------------?-------v-
-----------------------------????????-------------XX----------------------------------------?----------------------------------------------------------------------------------------------------------f-
-------------------------------------------------XXX------------------------------------X----------------------------------------------------------o--------------------X------------------------------f-
---------------------------------------------T--XXXX-----------------------------------XX--------------------------B------------------------------------------------------?????------------------------f-
---------------------------------------------|-XXXXX----------------------------------XXX-------------T-------------XXXXXXX-----?--------------------------X-------------------------------------------f-
--T------------------------------------------|XXXXXX-----------------M---------------XXXX-------------|-------------------------------T---------------------?-------------------------X----------------f-
--|-----o------------------------------------|XXXXXX--------------XXXX------M-------XXXXX------------?|-------------------------------|--T--------------------------------------------XX---------------f-
m-|-----o-----------------------------------X|XXXXXX-------------------------------XXXXXX-------------|-----------------E-------------|--|--------------------------------------------XXX--------------X-
XX|XXXXXXXXX-------XoXXXBBBBBBBBXXXXXXXXXX-XX|XXXXXXXXXXXXXXXXXXXXXXXXXXXXXXXXX---XXXXXXXXXXXXXXXXXXXX|XXXXXXXXXXXXXXXXXXXXXXXXXXXXXXX|XX|XXXXXXXXXXXXXXXXXXXXXXXXXXXXXXXXXXXXXXXXXXXXXXXXXXX-----XXXXXX-
