---------------------------------------------------------------------------------------------------------------------------------------------------------------------------------------------------------
-----------------------------------------------?------------------------------?--------------------------------------------------------------------------------------------------------------------------
---------------------------------------------------------------------------------------------------------------------------------------------------------------------------------------------------------
-----------------------------------------------------------------------------------------------------o-------------------------------------------------XXXXXXXX---------o--------------------------------
-------------------------X------------------o-------------------------------X-------------------BBBBB----------------------------------------------------------------------------------------------------
------------------------XX----------------------------------------?-----------------------------------------------------------------------------------------------------------o--------------------------
-----------------------XXX-------------------------------------------------------B-----------------------------------------------------------------------------------------------------------------------
----------------------XXXX--------------M-----------------------------------------------------------------------------------------------------------------------?------------------------------?-------v-
---------------------XXXXX-----------------------------------------------------------------------------------------------------------------------------------------------------------------------------f-
--------------------XXXXXX-------------------------------------------------------------------------------------------------------------------------o--------------------X------------------------------f-
-------------------XXXXXXX-------------------------------------------------------------X---------------------------------------------------------------------------------------------------------------f-
------------------XXXXXXXX----------------------------------------o---------XXX----------------------------X--------------------?--------------------------X-------------------------------------------f-
-----------------XXXXXXXXX-------------------------o----------------------------------------------M---------------------------------------------------------?--T---------------------------------------f-
------------X---XXXXXXXXXX--------------------------------------------------M------------------------?-----------------------?-----------T------------M--------|---------------------------------------f-
m--------------XXXXXXXXXXX----------------------------------------------------------------------------------------------E----------------|-----------------E---|---------------------------------------X-
XXXXXXXXXXXXXXXXXXXXXXXXXXXXX--XXXXXXXXXXXXXXXXXXXXXXXXXXXXXXXXXXXXXX--------XXXXXXXXXXXXXXXXXXXXXXXXXXXXXXXXXXXXXXXXXXXXXXXX------XXX---|----XXXXXXXXXXXXXXXXX|XX---XXXXXXXXXXX--XXXXX--XXXXXXXXXXXXXXX-
