-------------------------------------------------------------------------------M-------------------------M-----------------------------------------------------------------------------------------------
---------------------------------------------------------------------------------------------------------------------------------------------------------------------------------------------------------
-B-----------------------------------------M-------------------------------o----------------------------------------------------B----------------------------------------o----------------------------B--
-----------------------------------------------------------B--M-------------------------------------------------------B----------------------------------------------------------------------------------
--------------------X--------------------XXXXXXXX------------------o--------------------------------B-----------------------------------------------------------------------???-------------------o------
---------------------------------------------------------------------------------------------X------------------------------------Bo---------------------------------------------------------------------
--------------------------------------------------------------------------------B-----------XX------------------------------------X--o-------------------------------------------?-----------------------
-------------------------------------------------------------------------------------------XXX--------------------------------------------------------------------------------MT-----------------------v-
------------------------------------------------------------------------------------------XXXX------------?B-------------------------------------------------------------------|-----------------------f-
-------XXMXXXX------------------------?o----------------X--?-----------------------------XXXXX-X--------------------BX------------?-----------------------------BBBB-----------|----------------X------f-
-------------------------------------------------------------------------o------------XXXXXXXX----------------------------------------------XXX-------------------------------X|---------------XX---T--f-
---------o-----------------------------------?-----------------------------XX----------XTXXXXX---------------------------------o-----------------------------------------------|-----------o--XXX---|--f-
--------------------------------------------T----------?------------------------------XX|XXXXX-------------------------------------?------o------------------------------------|X------------XXXX---|--f-
-----------------------o--------------------|----------------------------------------XXX|XXXXX--------------------------------------------------o------------------XX-------T--|------------XXXXX---|--f-
mE---E-----------E-E------------------------|------------------------E-X-----E------XXXX|XXXXX-------X----------------E-------------E--------E------------------------------|--|---------E-XXXXXX--E|--X-
XXX------XXXXX-------XXXXXX?----XXXXXXXXX---|--XXXXXXXXXXXXXXX-----------XXXXXXXXXXXXXXX|XXXXXXXXXXXXXXXXXX--XXXXXXXXXXXXXXXXXXXXXXXXXXXXXXXXXXXXXXX---XXXXXXXXXXXXXXXXXXXXX|XX|-XXXXX----XXXXXXX---|--X-
