--------------------------------------------------------------------M----------------------------------------------------------------------------------------------------------------B-------------------
------------------------o----------------------?-------------------------------------------------------------------------------o-----------o-------------------------------------------------------------
---------------------------------------------------------------------------------------------------------------------------------------------------------------------------------------------------------
-----------------------------------------------------------------------------------------------------o-------M--------------------------------------------------------B-o--------------------------------
-------------------------X--------------------------------------------------X-------------------BBBBB--------------------------------------------???????-------------------------------------------------
------------------------XX-------------------------------------------------------------------------------------------------------------------------------------------------------------------------------
-----------------------XXX-------------------------------------------------------------------------------------------------------------------------------------------------------------------------------
----------------------XXXX-------------------------X-------------------------------------------------------------------------------------------------------------------------------------------?-------v-
---------------------XXXXX------------------------XX---------------------------------------------------------------------------------------------------------------------------------------------------f-
--------------------XXXXXX-----------------------XXX-----------------------------------------------------------------------------------------------o--------------------X------------------------------f-
-------------------XXXXXXX-------------------T--XXXX---------------------------------------------------------------------------------------------------------------------------------------X-----------f-
------------------XXXXXXXX-------------------|-XXXXX----------------------------------------------------------------------------?--------------------------X------------------------------XX-----------f-
-----------------XXXXXXXXX-------------------|XXXXXX-----------------M--------------------------------------------------------------------------------------?-------------------------X--XXX-----------f-
----------------XXXXXXXXXX--BBB--------------|XXXXXX--------------XXXX------M------------------------?-----------------------------------T--------------------------------------------XXXXXX-----------f-
m--------------XXXXXXXXXXX------------------X|XXXXXX--------------o-----------E-----------------------------------------E----------------|----------E---------------------------------XXXXXX------B----X-
XXXXXXXXXXXXXXXXXXXXXXXXXXBBBBBBXXXXXXXXXXXXX|XXXXXXXXXXXXXXXXXXXXXXXXXXXXXXXXXXXX-XXXXXXXXXXXXXXXXXXXXXXXXXXXXXXXXX----XXXXX------XXXXXX|XXXXXXXXXXXXXXXXXXXXXXXXXXXXXXXXXXXXXXXXXXXXXXXXXXXXXXXXXXXXXX-
