------------------------------------------o--------------------------------------------------------------------------------------------------------------------------------------------------------------
---------------------------------------------------------------------------------------------------------------------------------------------------------------------------------------------------------
---------------------------------------------------------------------------------------------------------------------------------------------------------------------------------------------------------
-------------------------------------------o-------------------------------------------------------------------------------------------------------------------------------------------------------------
----------------------------------------------------------------------------------X----------------------------------------------------------------------------------------------------------------------
-------------------o-------------------------------------------------------------XX----------------------------------------------------------------------------------------------------------------------
--------------------------------------------------------------------------------XXX----------------------------------------------------------------------------------------------------------------------
-------------------------------------------------------------------------------XXXX--------------------------------------------------------------------------------------------------------------------v-
------------------------------------------------------------------------------XXXXX--------------------------------------------------------------------------------------------------------------------f-
-----------------------------------------------------------------------------XXXXXX-------------------------------------------------------------------------------------------X------------------------f-
-------------------------------------X--------------------------------------XXXXXXX--------------------------------------------------------------------------------------------------------------------f-
------------------------------------XX-------------------------------------XXXXXXXX-----------X--------------------------------------------------------------------------------?-----------------------f-
-----------------------------------XXX------------------------------------XXXXXXXXX--------------------------------------X-----------------------------------------------------------------------------f-
----------------------------------XXXX-----------------------------------XXXXXXXXXX---------------------------------------------------------------------------------------X----------------------------f-
m------B-------------------------XXXXX----------------------------------XXXXXXXXXXX--------------------------------------------------------------------------------E-----------------------------------X-
XXXXXXXXXXXXXXXXXX?XXXXX--XXXXXXXXXXXXXXXXXXXXXXXXXXXXXXXXXXXXXXXXXXXXXXXXXXXXXXXXXXXXXXXXXXXXXXXXXXXXXXXX--------XXXXXXXXXXXXXXXXXXXXXXXXXX-------XXXXXXXXXXXXXXXXXXXXXXXXXXXXXXXXXXXXXXXXXXXXX-----XXX-
