-------------B-------------------------------------------------------------------------------------------------------------------------------------------------------------------------------------------
---------------------------------------------------------------------------------------------------------------------------------------------------------------------------------------------------------
---------------------------------------------------------------------------------------------------------------------------------------------------------------------------------------------------------
---------------------------------------------------------------------------------------------------------------------------------------------------------------------------------------------------------
---------------------------------------------------------------------------------------------------------------------------------------------------------------------------------------------------------
------------------------BBBBB----------------------------------------------------------------------------------------------------------------------------------------------------------------------------
-B------------------------------------------------------------------------------------------------------------------------------------------------------------BBBBBB-------------------------------------
-------------------------------------------------------------------------------------------------------------------------------------------------------------------------------------------------------v-
-------------------------------------------------------------------------------------------------------------------------------------------------------------------------------------------------------f-
-------------------------------------------------------------------------------------------------------------------------------------------------------------------------------------------------------f-
-------------------------------------------------------------------------------------------------------------------------------------------------------------------------------------------------------f-
-------------------T-----------------------------------------------------------------------------------------------------------------------------------------------------------------------------------f-
-------------------|--------------------------------------T--------------------------------------------------------------------------------------------------------------------------------------------f-
-------------------|--------------------------------------|-----------------------------------------------------------------------------X--------------------------------------------------------------f-
m------------------|--------------------------------------|------------------------------------------------------E---------------------------------------E---------------------------------------------X-
XXXXXXXXXXXXXXXXXXX|XXXXXXXXXXXXXXXXXXXXXXXXXXXXXXXXXXXXXX|XXXXXXXX------XXXXXXXXXXXXXXXXXXXXXXXXXXXXXXXXXXXXXXXXXXXXXXXXXXXXXXXXXXXXXXXXXXXXXXXXXXXXXXXXXXXXXXXXXXXXXXXXXXXXXXXXXXXXXXXXXXXXXXXXXXXXXXX-
