---------------------------------------------------------------------------------------------------------------------------------------------------------------------------------------------------------
---------------------------------------------------------------------------------------------------------------------------------------------------------------------------------------------------------
---------------------MB-------------------------------------------------------------------------------------B-----B----------------------------o-BB---------------------------------------------X--------
-------------------------------------------------------------o-------------------------------------------------------?--------------------?MB------------------------------o-----------------------------
--------------------------------------------------------------------------B-------------------------------------------------------------------------------------?MB-B---------B---B----------------------
------------o----------------------B--BB-----o--------------------------------------BB---------------------M-------------------B?--------------------BB------------------------------------BB------------
-----------------------??--------------------------------------------------------------------B-----------------------------------------B-----------------------------------------------------------------
---------------------------BX-------------o----------------------------B---------?-----------------o----------------MB-------------------------B---------MB---B------------X---------------------------v-
------------------M-B------o---------o--------------------------------------BB------------?--------------------------------------------------------------o------------------------?X-------------------f-
------------------------------------------------------------------------------------B------------------------o---------------------------------------------------------------BB------------B-----------f-
-------B-------X--------------------------------------BMM-----------------o-----------o---------B?oo-o---------------------------------o--MB---B--------------------------------M----------------o-o---f-
-----o----o--------?B?B-o-?---------------oo--------o-----XX?-B--B---------B-----------o---o------------o--------------------MBo---o-------o---o--M?-o--------BB------------------------XX--BB-----o---f-
-----oo--oo----o-o----------------BBo-Boo-o------------------o----B-o-------oo-o---BB-T-----------T------oo-BBBB-o--oo------o-----T--o--------oo---o-oB-------------------B-oooo------------------T----f-
-----T--TT------T-------T---------------o-T-----o---------------------------ooo-------|---T-------|-----T--------------------o----|-oo--------T-----T-----------------------o-T-------------------|----f-
m----|-E||------|-------|--E---------E-T--|-----T--------------E------------TT--------|---|-------|-----|-------E---T-------T-----|-T---------|-----|-----------------------T-|-------------------|--E-X-
X---X|XX||XXXXXX|XXX-XXX|XXXXXXXXXX----|XX|XXXXX|XXXXXXXXXXXXXXXXXXXXXXXXXXX||XXXXXXXX|XXX|XXXX-XX|XXXX-|XXXXXXXXXXX|-XXXXXX|XX-XX|X|X-XXXXXXX|---XX|XXXXXXXXXXXXXX-XXXXX---|X|XXXXXXXXXXXXXX-XXXX|-XXXX-
