--------------M-----------B------------------------------------------------------------------------------------------------------------------------------------------------------------------------------
---------------------------------------------------------------------------------------------------------------------B--------o--------o-----------------------------------------------------------------
--------------------------------------------------------------------------------------------------------------------------------------------------------------------------------------------o------------
---------------------------------------B---------------???-----------------------------------------------------------------------------------------------------------------------------------------------
-----------------------------------------------------------------------------------------------------------------------------------B---------------------------------------------------------------------
----------o-------------------------------?----------------------------------------------o-----------------------------------------------------------------------------------M---------------------------
---------------------------------------------------------------------------------------------------------------------------?????---------------------------------------------?----??????-----------------
-----------------------------------------------------------------------X-X-----------------------------------------------------------------------------------------------------------------------------v-
--------------------------------------???-----------B--------------------------------------------------------------BBB---------------------------------------------------------------------------------f-
----------------------------------------o-------B------------------------------------------------------------------o-----------------------------------------------------XXXX-----------------------o--f-
-------X----------------------------------------------------X-------------------------------------------BBBBB------------------------------------------------------------------------------------------f-
------XX---------------------------------------------------XX----------------------------------------------------------------?---T---------------------------T---X---------------------------XX--------f-
-----XXX------------------------------T---------T---------XXX--------------------------------------------------------------------|---------------------------|---XX------------------------------------f-
----XXXX------------------------------|---------|--------XXTX----------------------------------------------------B---------------|---------------------------|---XXX-----------------------------------f-
m--XXXXX-------E-------------XE--E----|-------E-|-------XXX|X---E----------------------------o-----------------------------------|------------------------E--|---XXXX--------E---o---------------------X-
XXXXXXXX--------XXXXXXXXX---XX-XXXXXXX|XXXXXX---|XXXXXXXXXX|XXXXXXXXXXXXXXXXXXXXXXXXXXXXXXXXX---------XXXXXX-----XXXXXXXXXXXXXXXX|XXXXXXXXXXXXXXXXXXXXXXXXXXX|XXXXXXXXXXXXXXXXXXXXXXXXXXXXXXXXXXXXXXX--X-
