-----------------------------------------------------------------------------------------------------------o---------------------------------------------------------------------------------------------
------------------------------------------------------------------o--------------------------------------------------------------------------------------------------------------------------------------
---------------------------------------------------------------------------------------------------------------------------------------------------------------------------------------------------------
-----------------------------------------------------------------------------------------------------------------------------------------------------------------o----------------------???????----------
---------------------------------------------------------------------------------------------------------------------------------------------------------------------------------------------------------
--------------------------------------------------------------------------------------------------M------------------------------------------------------------------------------------------------------
---------------------------------------------------------------------------------------------------------------------------------------------------------------------------------------------------------
--------------------------------?-------------------------------------------------X----X---------------------------------------------------------------------------------------------------------------v-
---------------------------------------------------------------------------------XX--------------------------------------------------------------------------------------------------------------------f-
--------------------------------------------------------------------------------XXX--------------------------------------------------------------------------------------------------------------------f-
--BBB--------------------------------------------------------------------------XXXX--------------------------------------------------------------------------------------------------------------------f-
----------------------------------------------------------------------T-------XXXXX--------------?---------------------------------------------------------------------------------M-------------------f-
----------------------------------------------------------------------|------XXXXXX---------------------------------------------------------------------o----------------------------------------------f-
-------------------??????---------------------------------------------|-----XXXXXXX--------------------------------------------------------------------------------------------------------------------f-
m-------------E-------------------------------------------------------|----XXXXXXXX--------------------E-----------------------------------------------------------------------------------------------X-
XXXXXXXXXXXXXXXX-----XXXXXXXXXXXXXXXXXXXXXXXXXXXXXXXXXXXXXXXXXXXXXXXXX|XXXXXXXXXXXX-XXXXXXXXXXXXXXXXXXXXXXXXXXXXXXXXXXXXXXXXXXXXXXXXXXXXXXXXXXXXXXXXXXXXXXXXXXXXXXXXXXXXXXXXXXXXXXXXXXXXXXXXXXXXXXXXXXXX-
