-------------------------------------------------------------------------------------------------------------------------------------------------------------------------------------B-------------------
------------------------------------------------------------------------------?------------------------------------------------------------o-------B-----------------------------------------------------
---------------------------------------------------------------------------------------------------------------------------------------------------------------------------------------------------------
-------------------------------------------------------------------------------------------------------------------------------------------------------XXXXXXXX-------B----------------------------------
-------------------------X------------------o-------------------------------------------------------M----------------------------------------------------------------------------------------------------
---------------X--------XX----------------------------------------?------------------------------o-------------------------------------------------------------------------------------------------------
-----------------------XXX-------------------------------------------------------B-----------------------------------------------------------------------------------------------------------------------
----------------------XXXX--------------M--------------------------------------------------------------------------------------------------------------------------------------------------------------v-
---------------------XXXXX---????????-------------------------------------------------------?----------------------------------------------------------------------------------------------------------f-
--------------------XXXXXX-----------------------------------------------------------------------------------------------------------------------------------------------------------------------------f-
-------------------XXXXXXX-------------------------------------------------------------X---------------------------------------------------------------------------------------------------X-----------f-
------------------XXXXXXXX----------------------------------------o---------XXX-----------------------T----X------------------------------------------------------------------------------XX-----------f-
-----------------XXXXXXXXX-------------------------o----------------------------------------------o---|-------------------------------T------------------------T-------------------------XXX-----------f-
----------------XXXXXXXXXX----------------------------------------------------------------------------|-------------------------------|---------------M--------|------------------------XXXX-----------f-
m--------------XXXXXXXXXXX----------------------------------------o-----------E---E-------------------|-------------------------------|--------------------E---|-----------------------XXXXX-----------X-
XXXXXXXXXXXXXXXXXXXXXXXXXXXXXXXXXXXXXXXXXX---XXXXXXXXXXXXXXXXXX??????--------XX--------XXXXXXXXXXXXXXX|XXXXXXXXXXXXXXXXXXXXXX------XXX|XXXXXXXXXXXXXXXXXXXXXXXX|XXXXXXXXXXXXXX----XXXXXXXXXXXXXXXXXXXXXX-
