---------------------------------------------------------------------------------------------------------------------------------------------------------------------------------------------------------
---------------------------------------------------------------------------------------------------------------------------------------------------------------------------------------------------------
------?B-------------------o----X---------------------------XB----------------------------B-----------------M----------------------X-------------------?------------?MB----------------------------------
-------------------B-?------?M-----------------------B--------------------------------------M-------M--------------------------------------B-------?-----M--B-----o---o------M-----------------------X---
-----------------------------------------------B-----------------------------------B-----------B-------------------------------B-------------------------------------------------M-----------------------
---------B-----------------------------------------------------------------B------------------------------------B--------o------------------------------------------------------------B------------------
---------------------------o-------------o--------?M--------B-------------------------------------------------------M-----------X-------------------------------------------------XB------------------X--
-------------------M----------------------------B-------------------------------------M------------------------o------------------X---?---------------B-----BB------------------o-----------------?----v-
--------------------M?---------------------------------------------------B------------------------------------------------------------o-----------B-----------------B--------------------o-------------f-
-----------------------------------------------------------------------------------------------B-----------------------------------------?-?-----------------------------------------------------------f-
-----------o------------------?--------------o--M--?B------?-M-------------oo--o---oo----------------------------------?BB?------------------o-------?Booo?-B-o------------??-BBMB-----------B-?B------f-
----------------B-?-oo--XB-XBM------oooo--------------B-o--o-----M-------------o---o-MB--------------oo----M-o-o---?B--------XM?X-o------o----o----o------------MB?--X?-----------MB-------MX-----oo-o-f-
----B-oBB--T---------o---o---------oT-------o----------oo--------o-o------oT--T----T--ooo--------o------o----ooo------o-ooooo-----T---BB-oo-T--o---oB---T-----o-------oo--oo--o---------oo-------oo--T-f-
-----T-----|--------T---------------|------T-----------T------T---T--------|--|----|---T---------T---T------T-T-------o-oooo------|oo----T--|-T---o-----|-----------------T----------------------T---|-f-
m----|-----|--------|---------------|------|-----------|------|---|-----E--|--|----|---|---------|---|------|-|------T--TT-T------|T-----|-E|-|---T-----|---------------E-|-------------T----EE--|-E-|-X-
X---X|XXXXX|XXXXXXXX|XXX-XXXX-XXXXXX|XXXX-X|XXXXXXXXXXX|XXXXX-|XXX|XXXXXX-X|XX|XXXX|-XX|XXX---XXX|-XX|XXXXXX|X|XXXXX-|-X||X|X-XXX-||XX-XX|XX|X|XXX|-XXXX|XXXXXXXXXXX-XXXXX|XXXXXX-XXXXX-|XXXXXXXX|-XX|XX-
