---------------------------------------------------------------------------------------------------------------------------------------------------------------------------------------------------------
---------------------------------------------------------------------------------------------------------------------------------------------------------------------------------------------------------
------XB---B--------------?--------------o-----------------o--------------------BX-------------------BB-------B----------------------------?-------o------------------------X----------------------------
---------------------M-------------B----------B-------------B-----------?X---------B---o-----------M-------------BBB--------------?---------??------------------------?BB--------------------------------
-------------M-oB?------------------------------------------------------------M--------------------o-------o-----------------------------------o--------XBM-----------------------B-B-----------BMoBB----
-----------B--------o-------------------------------?BM----------o-B----------------?B-----B------o---B----------------------------------------------------MB---------------------------------------o----
------------------------B------------B--?------------------B-------------------?B----------------------------------------------------o--------------------------------------------------B----------------
-----------------------------o----------------E----------------------------------------------------B-----oB------------------B--------------------M----------------M--X?-B--XM--MB-------?------------ov-
----?-----------------------------B?-------------------------------B----B------------------X------------------------------------------------------------------------B----------------------------------f-
----------------------o------o---------------------------B------B---------------------------------------------------------------------------------o--X-------------------------------------------------f-
--------------B----o------------------o------------X-------------------------XM-----E-------------B-oo---BB--o------o---o---o---o-----o---------------------X----X-------B------------------------o----f-
---------o--o----X?-M-----BX---------oo----B--------------BX--o-------------------X-B-BMM---B-B-o---o--B---o--o--o------o---------?B---------BX------------ooX---oB------o-?BB?---o----o---------B-oBo-f-
-------B--o----oo--oo--o---------BB--o--B---o-o--B--B----oo--Bo-B------B---oo-------o-----------o---T-o----ooT--o---T------o------------o-----o----------oooo-----------o-oo---o-------o-----o--o-T---of-
---------T---------------------------T------T-o----------o----T------------o------------------------|------T-|------|------------------T---------TT--------T------------T-oo-----o-----T-----T-T--|--T-f-
m--------|---------T----E------------|------|-T----------T----|------------T----E------------------E|------|-|------|------------------|---E---E-||--E-----|-----------E|-T-----T------|-----|-|--|--|-X-
X---XXXXX|XXXXX-XX-|XXX-XXXX-XXX-XXXX|X-XX-X|X|XXXXXXXXXX|X--X|XXX--XX-XXXX|X-XXXXXXXXXXXXXX---X-XXX|-XXX-X|X|X-XXXX|XXXXXXXXXXXX---XXX|XXXXX-XXX||XXXXXXXX|XXXXXXXXXXXX|X|XX-XX|--XXXX|XXXXX|X|X-|XX|XX-
