----------------X----------------------------------------------------------------------------------------------------------------------------------------------------------------------------------------
---------------------------------------------------------------------------------------------------------------------------------------------------------------------------------------------------------
---------------------------------------------------------------------------------------------------------------------------------------------------------------------------------------------------------
------------------------------------------------------------------------------------------------------------B--------------------------------------------------------------------------------------------
---------------------------------------------------------------------------------------------------------------------------------------------------------------------------------------------------------
---------------------------------------------------------------------------------------------------------------------------------------------------------------------------------------------------------
---------------------------------------------------------------------------------------------------------------------------------------------------------------------------------------------------------
------------------------------------------------------------------------------------------------------------------------------------------------------B------------------------------------------------v-
-------------------------------------------------------------------------------------------------------------------------------------------------------------------------------------------------------f-
-----------------------------------------------o-------------------------------------------------------------------------------------------------------------------------------------------------------f-
-------------------------------------------------------------------------------------------------------------------------------------------------X-----------------------------------------------------f-
-------------------------------------------------------------------X----------------------------------------------------------------------------XX-----------------------------------------------------f-
-------------------------------------------------------------------XX--------------------------------------------------------------------------XXX-----------------------------------------------------f-
-------------------------------------------------------------------XXX------------------------------------------------------------------------XXXX----------------------------------------------------Xf-
m--------------E---------------------------------------------------XXXX---X------------------------------------------------------------------XXXXX----------------------------------------------------XX-
XXXXXXXXXXXXXXXXX-------XXXXXXXXXXXXXXXXX--XXXXXXXXXXXXXXXXXXXXXXXXXXXXXXXXXXXXXXXXXXXXXXXXXXXXXXXXXXXXXXXXXXXXXXXXXXXXXXXXXXXXXXXXXXX------XXXXXXXXXXXXXXXXXXXXXXXXXXXXXXXXXXXXXXXXXXXXXXXXXXX-------XX-
