--------------------o----------------X-------------------------------------------------------------------M-----------------------------------------------------------------------------------------------
---------------------------------------------------------------------------------------------------------------------X-----?-----------------------------------------------------------------------------
-----------------------------------o-------------------------------------------------------------------------------------------------------------------------------------o-------------------------------
----------------?-------T-----X-----------------------------------------------------------------------------------BBBBB----------------------------------------------------------------------------------
------------------------|------------------------------------------o-------------------------------------------------------------------------------------------------------------------------------------
--------o---------------|---------------------------------------------------------------------------------------------------------Bo---------------------------------------------------------------------
------------------------|-----------------------------------B--------------------o---------------------------------------------------o------BBBBBB-------------------------------?-----------------------
-----------------------T|----------------------------????--X----------------------------------------------------------------B--------------------------------------------------BBBBB-------------------v-
----------------?------||------?--------------------------XX-----------------------------------------------B----------------------------------------------------------------------------------o--------f-
-----------------------||-----------------------o--------XXX----------------------------------------X----------------X------------?-------------------------------------------------------------X------f-
-----------------------||-------------------------------XXXX---------------------------------------XX------------------------------------------------------------------------------------------XX---T--f-
---------------------?-||------------------------------XXXXX--------------------------------------XXX--------------?????----------------------------------------------------------------------XXX---|--f-
-----------------------||-----------B-----------------XXXXXX------------------------------X------XXXX-------------------------------------o---------------------------M----------------------XXXX---|--f-
--------------------M--||------X---------------------XXXXXXX------------------------------XX----XXXXX---------------------------------------------------------------------------------------XXXXX--B|-?f-
m-------E--------------||------XX----EE-------------XXXXXXXX----------------------E-E-----XXX--XXXXXXX----------------E----------------------EE--------E---E-------------E-----------------XXXXXX-E-|--X-
XXXXX---XXXXXXXXXXXXXXX||XXX---XXXXXXXXX--X?XXXXXXXXXXXXXXXX-------------XXXXXXXXXXXXX----XXXXXXXXXXXXXXXXX-------XXXXXXoXXXXXXXXXXXXXXXXXXXXXXXXXXXXXXXXXX---XXXXXXXX?XXXXXXXXXXXXXXXXBXXXXXXXXX---|--X-
