----------------?---------------------------------------------------M------------------------------------------------------------------------------------------------------------------------------------
------------------------o----------------------?------------------------------?------------------------------------------------o-------------------B-----------------------------------------------------
---------------------------------------------------------------------------------------------------------------------------------------------------------------------------------------------------------
-----------------------------------------------------------------------------------------------------o-------------------------------------------------XXXXXXXX---------o--------------------------------
--------------------------------------------o-------------------------------X-------------------BBBBM----------------------------------------------------------------------------------------X-----------
------------------------------------------------------------------?------------------------------o-------------------------------------------------------------------------------------------------------
---------------------------------------------------------------------------------B-----------------------------------------------------------------------------------------------------------------------
----------------------------------------M----------X---------------------------------------------------------------------------------------------------------------------------------------------------v-
-----------------------------????????-------------XX----------------------------------------?----------------------------------------------------------------------------------------------------------f-
----o--------------------------------------------XXX------------------------------------X----------------------------------------------------------o--------------------X------------------------------f-
---------------------------------------------T--XXXX-----------------------------------XX--------------------------B-----------------------------------------------------------------------------------f-
---------------------------------------------|-XXXXX--------------o---------XXX-------XXX-------------T-------------------------?--------------------------X-------------------------------------------f-
--T------------------------------------------|XXXXXX-----------------M---------------XXXX---------o---|-------------------------------T---------------------?--T---------------------------------------f-
--|-----o---X--------------------------------|XXXXXX--------------XXXX------M-------XXXXX------------?|-------------------------------|--T------------M--------|---------------------------------------f-
m-|-----o--------------------E--------------X|XXXXXX-------------------------------XXXXXX-------------|-----------------E-------------|--|-----------------E---|------------------------E--------------X-
XX|XXXXXXXXX-------XoXXXBBBBBBBBXXXXXXXXXX-XX|XXXXXXXXXXXXXXXXXXXXXXX--------XX---XXXXXXXXXXXXXXXXXXXX|XXXXXXXXXXXXXXXXXXXXXX------XXX|XX|XXXXXXXXXXXXXXXXXXXXX|XXXXXXXXXXXXXX----XXXXXXXXXXXXXXXXXXXXXX-
