---------------------------------------------------------------------------------------------------------------------------------------------------------------------------------------------------------
---------------------------------------------------------------------------------------------------------------------------------------------------------------------------------------------------------
----o-----------------EB-----------------M-B-------oo------------------B---------------B---------------------------BM-------------o----------------------------X-----------------------------------------
-------B-MB-----------------------------------------------------------------o-------------MB--------------------------------------o-----B---------------B----------------------------B-------------------
---------------BB-B-M-------------------------------------o--B---------------------------------------------------------BB?o----?B-------------------------------------M----------------------------------
------------------------------------------------X----------------------------------------------------------?-------------------------------o-----------------------B-------------------------------------
----------------------------BB----------------------------------------------XB--------------------B----------------?X---o-------------------------B--B--X-------X-------------------XX-------------------
-----------------B-----------------MB---o------------B???------------------o-----M----------------------------M?------BX-----------------------------------------------M-----------------------o-------v-
----------------------------------------------------------------------B--B-------------------------------------------------?----?-------------------------o--------------------------------------------f-
--------------B---------------------------------------------------------------------------------------------------------?--------------------------------o---------B-----------------------------------f-
------------o---B----X-?------------o-----o-------?-M-------------------------o-o--------o---oo-BMM------o-X--------B-------------BMoo--oBX------BBB-------??------------BX??M-B-o---------o-o-M-?-----f-
-----------o------?-------ooBB---------o??o-o-MM----oBBXB----?o------XB--XB--o---------??-o---oo------BM-----oBB-oo--------------oo--ooo--------o---------------MM--BBBM--------o--B?-B-XB?oo----o-----f-
----B---B---------o------o--------o-oo-o----o-----o-----------o-o-B-----------T----------T-o--T-o----------------oo--BB--BB-o--------TT--------------------o-BBB-----------o----T-------o--TT--------o-f-
-----------------oo-------T-------o---o----T------------------T---------------|----------|T---|-o---------------TT------o-------T----||-----------------------------------------|------o---||----------f-
m----------------T-E------|---E---T--T-----|------T-----------|---------------|EE--------||---|-T---E-----------||-----T--------|----||--E----------------T---------E----E------|------T---||----------X-
X---XXXXXXXXXXXXX|XXXX-X-X|XXXXXXX|--|XXX-X|XXXXXX|XXX-XX-XXXX|XXXXXXXXXXXXXXX|XXXX-XXXXX||XXX|X|X-XXXXXXXXXX-XX||XXXXX|-XXXXXXX|XXXX||XXX-XXXX----XXXXXXX|XXXXXXXX-XXXXXXXXXXX-|---XXX|XXX||XXXX-XXXXXX-
