----------------?---------------------------------------------------M------------------------------------------------------------------------------------------------------------------------------------
------------------------o----------------------?------------------------------?--------------------------------------------------------------------B-----------------------------------------------------
---------------------------------------------------------------------------------------------------------------------------------------------------------------------------------------------------------
-------------------------------------------------------------------------------------------------------------M-----------------------------------------XXXXXXXX---------o--------------------------------
--------------------------------------------o-------------------------------------------------------M----------------------------------------------------------------------------------------X-----------
---------------X--------------------------------------------------?------------------------------o-------------------------------------------------------------------------------------------------------
---------------------------------------------------------------------------------B-----------------------------------------------------------------------------------------------------------------------
----------------------------------------M----------X-------------------------------------------------------------------------------------------------------------------------------------------?-------v-
-----------------------------????????-------------XX----------------------------------------?----------------------------------------------------------------------------------------------------------f-
-------------------------------------------------XXX------------------------------------X----------------------------------------------------------o---------------------------------------------------f-
---------------------------------------------T--XXXX-----------------------------------XX--------------------------B-----------------------------------------------------------------------------------f-
---------------------------------------------|-XXXXX--------------o---------XXX-------XXX-------------T-------------------------?----------------------------------------------------------------------f-
--T------------------------------------------|XXXXXX-----------------M---------------XXXX-------------|-------------------------------T---------------------?--T---------------------------------------f-
--|-----o---X--------------------------------|XXXXXX--------------XXXX--------------XXXXX-------------|-------------------------------|--T------------M--------|---------------------------------------f-
m-|-----o--------------------E--------------X|XXXXXX-------------------------------XXXXXX-------------|-------------------------------|--|---------------------|------------------------E--------------X-
XX|XXXXXXXXX-------XoXXXBBBBBBBBXXXXXXXXXX-XX|XXXXXXXXXXXXXXXXXXXXXXX--------XX---XXXXXXXXXXXXXXXXXXXX|XXXXXXXXXXXXXXXXXXXXXX------XXX|XX|XXXXXXXXXXXXXXXXXXXXX|XXXXXXXXXXXXXX----XXXXXXXXXXXXXXXXXXXXXX-
