----------------?----------------------------------------------------------------------------------------------------------------------------------------------------------------------------------------
------------------------o-----------------------------------------------------?--------------------------------------------------------------------B-----------------------------------------------------
---------------------------------------------------------------------------------------------------------------------------------------------------------------------------------------------------------
-------------------------------------------------------------------------------------------------------------------------------------------------------XXXXXXXX------------------------------------------
--------------------------------------------o-------------------------------------------------------M----------------------------------------------------------------------------------------X-----------
------------------------------------------------------------------?------------------------------o-------------------------------------------------------------------------------------------------------
---------------------------------------------------------------------------------B-----------------------------------------------------------------------------------------------------------------------
----------------------------------------M----------X---------------------------------------------------------------------------------------------------------------------------------------------------v-
-----------------------------????????-------------XX----------------------------------------?----------------------------------------------------------------------------------------------------------f-
-------------------------------------------------XXX------------------------------------X--------------------------------------------------------------------------------------------------------------f-
---------------------------------------------T--XXXX-----------------------------------XX--------------------------B-----------------------------------------------------------------------------------f-
---------------------------------------------|-XXXXX--------------o---------XXX-------XXX-------------T------------------------------------------------------------------------------------------------f-
--T------------------------------------------|XXXXXX---------------------------------XXXX-------------|-------------------------------T------------------------T---------------------------------------f-
--|-----o---X--------------------------------|XXXXXX--------------------------------XXXXX-------------|-------------------------------|---------------M--------|---------------------------------------f-
m-|-----o--------------------E--------------X|XXXXXX-------------------------------XXXXXX-------------|-------------------------------|------------------------|------------------------E--------------X-
XX|XXXXXXXXX-------XoXXXXXXXXXXXXXXXXXXXXX-XX|XXXXXXXXXXXXXXXXXXXXXXX--------XX---XXXXXXXXXXXXXXXXXXXX|XXXXXXXXXXXXXXXXXXXXXX------XXX|XXXXXXXXXXXXXXXXXXXXXXXX|XXXXXXXXXXXXXX----XXXXXXXXXXXXXXXXXXXXXX-
