--------------------------------------------------------------------------------------------------------------------------------------------B--------------------------------------------------o---------
-----------------------------------------------------------------------------------------------XXXXXXXX----------------------X---------------------------------------------------------------------------
----------------------------------------------------------------------------------------------------------M-------------------------XXXXX----------------------------------------------------------------
-----------o------X-------B------------------------------------------------------------------------------o-----------------------------------------------X-----------------------------------------------
----------------------------------------------------------------------------------------------------B----------------------------------------------------------------------------------------------------
------------------------------------------------------------------------------------------------------------------------------------------??????---------------------------------------------------------
---------------------------------------------------------------------------------------------------------------------------------------------------------------------------------------------------------
---------------------------------M---------------------------------------------------------------------------------------------------------------------------------------------------------------------v-
-------------------------------------------------------------------------o----X------------------------------------------------------------------------------------------------------------------------f-
--T--------------------------------------------------------------------------------------------------------------------------------------------????????------------------------------------------------f-
--|----------------------------------------------------------------------------------------------------------------------------------------------------------------------------------------------------f-
--|---------------------------------------------TX--------------------------------------------------XXXXXXX--------------------------------------------------------------------------------------------f-
--|---------------------------------------------|------------------------------------------------T-----------------------------------------------------------------------------------------------------f-
--|----------------------------------X----------|------------------------------------------------|----------------X------------------------XXXB----X---------------------------------------------------f-
m-|---E---EE-----E-------------------XX---------|----E-------------------------------------E-----|-----------E-E--XX-E----------X----E----------E-XX-----------------------------E?E-------------------X-
XX|XXX--------XXXXX-------XXXXXXXXXXXXXXXXXXXXXX|XXXXXXX--------XXXXXXXXXXXXXXXXXXXX---XXXXXXXXXX|XXXXXXXXXXXXXXXXXXX-XXXXXXXXXXXXXXXXXXXXXXXXXXXXXXXXXXXXXXXXXXXXXXXXXXXXXXXXXXXXXXXXXXXXXXXXXXXXXXXXXX-
