---------------------------------------------------------------------------------------------------------------------------------------------------------------------------------------------------------
-------------------------------------------------------------------------------------------------------------------------------------------------------------------BBBBBBBB------------------------------
---------------------------------------------------------------------------------------------------------------------------------------------------------------------------------------------------------
------BBBBBB------------------------------------------------------------------------------------------X------------------------------------o-------------------------------------------------------------
---------------X-----------------------------------------------------------------------------------------------------------------------------------------------------------------------------------------
--------------XX---------------------------------------------------------------------------------------BBBBBBB-------------------------------------------------------------------------------------------
-------------XXX-?---------------------------------------------------------------------------------------------------------------------------------------------------------------------------------------
------------XXXX---------------------------------------------------------------------------------------------------------------------------------------------------------------------------------------v-
-----------XXXXX---------------------------------------------------------------------------------------------------------------------------------------------------------------------------------------f-
----------XXXXXX-------------------------------------------------------------------------------------------------------------------------------X-------------------------------------------------------f-
---------XXXXXXXX-------------------------------------------X---------------------------------------------------------------------------------XX-------------------------------------------------------f-
--------XXXXXXXXX------------------------------------------XX--------------------------------------------------------------------------------XXX----------T--------------------------------------------f-
-------XXXXXXXXXX------T----------------------------------XXX-------------------------------------------------------------------------------XXXX----------|--------------------------------------------f-
------XXXXXXXXXXX------|---------------------------------XXXX------------------------------------------------------------------------------XXXXX----------|--------------------------------------------f-
m----XXXXXXXXXXXX------|------E-------------------------XXXXX-------E--------------------E---------------------o--------------------------XXXXXX----------|--------------------------------------------X-
XXXXXXXXXXXXXXXXXXXXXXX|XXXXXXXXXXXXXXXXXXXXXXXXXXXXXXXXXXXXXXXXXXXXXXXXXXXXXXXXXXXXXXXXXXXXXXXXXXX---XXXXXXXXXXXXXXXXXXXXXXXXXXXXXXXX--XXXXXXXXXXXXXXXXXX|XXXXXXXXXXXXXXXXXXXXXXXXXXXXXXXXXXXXXXXXX???X-
