---------------------------------------------------------------------------------------------------------------------------------------------------------------------------------------------------------
--------------------------------------------------------------------------?------------------------------------------------------------------------------B-------------------------------------XX--------
------------------------------------------------------------------------------??------------------------------------------------------?------------------------------------------------------------------
---------------------------------------------------------------------------------------------------------------------------------------------------------------------------------------------------------
-----------------------------o--------------------------------------------------------------------------------------------------------------------------------------------BBBBBBB------------------------
---------------------------------------------------------------------------------------------------------------------------------------------------------------------------------------------------------
---------------------------BBBBBBBB---------------------????---------------------------------------------------------------------------------------------------------------------------------------------
------------------XX----?------------------------------------------------------------------------------------------------------------------------------XXX---------------------------------------------v-
-------------------------------------------------------------------------------------------------------------------------------------------------------------------------------------------------------f-
------------------------------------------------------------------------------------------------------------------------------------------------------------------------------------------------------Xf-
-----------------------------------------------------------------------------------------------------------------------------------------------------------------------------------------------------XXf-
-----------------?--------------------------BBBBBBBB------------------------------------------------------------------o-----------------------------------------------------------------------------XXXf-
-------------------------------------------------------------------------------------------------------------------------X---------------------o-----------------------o---------------------------XXXXf-
---------------------------------------------------------------------------------------------------------------------------------------------------------------------------T-----------------X----XXXXXf-
m--------------------------------------------------------------------------E---------------------------------E-----------------------------E-?------------------------E----|---------E-------XX--XXXXXXX-
XXXXXXXXXXXXXXXXXXXXXX------XXXXXX-------XXXXXXXXXXXXXXXXXXXXXXXX-----XXXXXXXXXXXXXXXXXXXXXXXXXXXXXXXXXXXXXXXXXXXXXXXXXXXXXXXXXXXXXXXXXXXXXXXXXXXXXXXXXXXXXXXXXXXXXXXXXXXXX|---XXXXXXXXXXXXXXXXXXXXXXXXX-
