E------------------------------------------------------------------------------------------------------------------------------------------------------------------------------------------------------X-
o------------------------------------------------------------------------------------------------------------------------------------------------------------------------------------------------------|-
M--------------------X---------------------------------------------------------------------------o-------------------------B---------o-X---------------M------------------B---E------------------------M-
|----B-----------------?X-------------------o---------B------------------------o----XB--------MM----------------BM----------X---------------------------------BMX-------------B--------------?M?-------?-
?----------------BB------X--------B?-----B?-----------o---------------------------------------------B--------------------------B-----o------B---------------------------------------------------B-B----E-
o------B-----------B-----o-------------------------BB------------------------B----------oo-------?M-------------------------------------------------------------------M--------------------------------T-
B-------------B?M---------------------------------------------------X-----------------------------------------?B?------------------??----------------------------------B--o-------X----------------------
|------------------------------------------------------------XX-----------BB-----------------o--------------o--------------M-------------B-----------------------------------------M----------------B--v-
-----?XM----------------------o------------B----BB--MB-----------------o-----X-----XM-B--------------------------------B--------------------BB-------o-------------------------------BB---------B------T-
T-----o----------------------------------------------------------M---------------------------------BX----------------------------------------------------------------B----------------------?----------o-
B----------o--XB-------------------------?---------------------o---o----X----------------------------B--o-------------------o-?BB------XM----------------------------------------??-----------o--------T-
E-----o-M?----------o---?M-?--------M?B-?-B------MMM--------?Bo-?o-----ooo--o-Mo------MB--X-oM?B---oo---o-o----------X?B-----o--oX---------BMM?o--o------------------o----------o-------------oo-------T-
o-----o----o--------o----o--B----------o------oo--o--BB-------T-----B-----o-o---o--o-------o-----o-oo----T--------o---------To----BB-----BB----o-----BB----oo-------o-------oo-o---o--o--oo--oT-o--BB--?-
?-----T----------------o----------------o---o-o---------------|--To----T-T-----T---oo------T-------T-----|-----------------o|-------------------------------o-------TT---------T---oo-------T-|-T--------
m-----|-----------T---T----------------T---T--T---------------|--|T----|-|-----|---T-------|-------|-----|----------------T-|------------------------------T-E------||------T--|---TT-------|-|-|------T-
X---XX|X-XXX-XXXXX|--X|XXXXXXXXXXX-XXXX|XXX|-X|-XXXXX-XXXXXXXX|XX||-XXX|X|X---X|XXX|XXXXXXX|XXXXXXX|-XXXX|XXX-XXXXXXXX-XXX|X|XXXXXX-XXXXXXX--------XXXX-XXX|XXXXXXXX||X-XXXX|X-|-XX||-XX--XX|X|-|XX--XXX-
