------------------------------------------B-------------------------------------------------------------------------------------------------------------------------------------------B----------XXXXXX--
--------------------------------------X-----------------------------------------------------------------------------------------------------------------------------?------------------------------????--
--B----------------------------------------------------------------------------------------------------------------------------------------------------------o-------------------------------------------
---------------------------------------------------------------------------------------------------------------------------------------------------------------------------------------------------------
---------------------------------------------------------------------------------------------------------------------------------------------------------------------------------------------------------
---------------------------------------------------------------------------------------------------------------------------------------------------------------------------------------------------------
---------------------------------------------------------------------------------------------------------------------------------------------------------------------------------------------------------
----------------------------------------------------------------------------------------------------------------------------------------------X---X----------------------------------------------------v-
----------------------------------------------------------------------------------------------------------------------------------------------XX-XX----------------------------------------------------f-
---------------------------------------------------------------------------------------------------------------------------------------------XXXXXXXX--------------------------------------------------f-
--------------------------------------------------------M---------------o--------------------------------------M------------------------------XXXXX----------------------------------------------------f-
----------------------------------------------------------------------------------X-----------------------------------------------------------XXXXX----------------------------------------------------f-
----------------------------------------------------------------------------------XX---------------------------------------------------------XXXXXXX------------------------------------------T---M----f-
---------------------------------------------------------------------------T------XXX--------------------------------T----------------------XXXXXXXXX-----------------------------------------|--------f-
m-------------E-------E----------------------------------------E-----------|------XXXX-------------------------------|---------------------XXXXXXXXXXX---------------------------E------------|--------X-
XXXXXXXXXXXXXXXXXXXXXXXXXXXXXXXXXXXXXXXXXXXXXXXXXXXXXXXXXXXXXXXXXXXXXXXXX--|---XXXXXXXXXXXXXXXXXXXXXXXXXXXXXXXXXXXXXX|X---XXXXXXXXXXXXXXXXXXXXXXXXXXXXXXXXXXXXXXXXXXXX----XXXXXXXXXXXXXXXXXXXX|XXXXXXXXX-
