--------------------------------------------------------------------------------------------------------------------B------------------------------------------------------------------------------------
---------------------------------------------------------------------------------------------------------------------------------------------------------------------------------------------------------
------------------------------------------------------------------------------------------------------------------M--------------------------------------------------------------------------------------
-----------------------------------------------------------------o---------------------------------------------------------------------------------------------------------------------------------------
---------------------------------------------------------------------------------------------------------------------------------------------------------------------------------------------------------
-----------------B--------------------------------------------------------------------------------------o------------------------------------------------------------------------------------------------
------------------------------------------------------------------------------------------------------------------------------------X--------------------------------------------------------------------
-------------------------------------------------------------------------------------------------------------------------------------------------------------------------------------------------------v-
------------------------------o--------------------------X---------------------------------------------------------------------------------------------------------------------------------------------f-
--------------------------------------------X---------------------------------------------------------????-----------------------------------------------------M?????----------------------------M-----f-
------------------------------------------------------------X--------------------------------------------------------------------------------------------------------------------B---------------------f-
--------------------------------------------------------------------------------------------------X-----X----------------------------------------------------------------------------------------------f-
-------X-----------------------------------------------------------------------------------------------------------------------------------------------------------------------------------------------f-
------------------------------------------------TB-------------------------------------------------------------------------------X-------------------------------------------------o-------------------f-
m------------E-------------------X--------------|-------------------E-------E-----------B--------------E-------------E------------------------E------------------E-------------------------------------X-
XXXXXXXXXXXXXXXXXXXXXXXXXXXXXXXXXXXXXXXXXXXXX---|----XXXXXXX--XXXXXXXXXXXXXXXXXXXXXXXXX------XXXXXXXXMXXXXXXXXXXXXXXXXXXXXXXXXXXXXXXXXXX--------XXXXXXXXXXXXXXX------XXXXXXXXXXXXXXXXXXXXXXXXXXXXXXXXXXX-
