---------------------------------------------------------------------------------------------------------------------------------------------------------------------------------------------------------
---------------------------------------------------------------------------------------------------------------------------------------------------------------------------------------------------------
--------------------------------------------------------------B-BB--M--X-----------------------BB------------o-o------B-----------------------M?----B-------------M--B-----------------------B-----------
----BB---B--B---------------ooo------------------B------------------------------------------------------------------------------------M----------------------E-----XB--------BB---------------------B----
--------------------------B-----MB-----B-----------------------------------------------?M?--------------X----------?-----------------------------------B--------------------o--------------------M-------
------------------X------------------------------o-X-?-------------------------------------------o--------------?----------o-------------------------BB------------------B?------------------------------
------B----------o--------------------------------------B-?--------------B---o?----------------MB--------------------------------B-----------------------o---------------------o-------------X?----------
-----------------------?--B----------------------------o--o-----------BB--------------o------------------B------------o?----------B-----------MX-------X------------B---------------------M---o--------v-
-----------------------o---B--------------------------------------B---------------B------------------------------------------------------------------------------------------------B-------------------f-
------------------------------------B-----------------------------o----o--------------------------o----------------------------------------------------------------------------------------------------f-
-----------o------?M---o----XMB----------X--------oM?----------BX------------------o-------X--o--------------o------------------B---B--o-------------------------------o--------------------?B?--------f-
-----------o-?--o------oo-----------------oo-o------o---------------o----XBB?M---o---o-M?----------oo---XB-X--o------X??---o----------------oX?--XXB-M-MBMBX---o?---------XMX------X?------------B-----f-
-----------o----o---o-o---B-----------oo---o-----T----o-----------------------BB-o------o---B--B--B-o-oooo---T------o----------------B-----------o---------o---o---BBo-o-----o-------oo-ooB------------f-
---------------T------o---------------T---T------|----------------------------------T--------------T---o-----|-----T------------------------------------------T-------o--------------o-o-o-----------T-f-
m--------------|-----T------E---------|---|------|----------------------------------|------E-------|--T------|E----|----E----E---------E----------------------|-------T--------EE----TT-T-----E------|-X-
X---XXXXXXXXX--|XXXXX|--XX-XXXXXXXXXXX|X--|-XXXXX|XXXXXXXXXXXXXXXXXXXXXX--XXXXXXX-XX|XXXXXXXXXXXXXX|XX|XXXXXX|X-XXX|XXXXXXXXXXXX-XXXX-XXXXX-XXXXXXXXXX-XXXXXXX|XXXXXXX|---XXXXXXXX-XX||X|XXXXXXXXXXXX|XX-
