B------------------------------------------------------------------------------------------------------------------------------------------------------------------------------------------------------?-
-------------------------------------------------------------------------------------------------------------------------------------------------------------------------------------------------------X-
|-------------M-----------------------------------BX---------------------------------------------B----------XM--------------------------------?-----------------------E--EE------------?---o-----------?-
?-------------------------o-------------B-------------------------------------------o-------------------------------------------------------------B-------------------------------------M----E---------B-
E-------------------------------------------------------BX-----------BB------------------------------------------------X------------------------B---------B-------BME----------B------E----------------o-
T------BB---------------------------------------BBB-----oo-------------B-----------------------B?-----------------o-----------------------------------?---------B--o-----------------------------------M-
X-----------------------------?XB--------------------BB-----------------------------X---------------BB------B---------------------------X-------------------M--------------------------E-----EX--------T-
T------------------o-------------------BB------o--------------------------------------------------------------------------B--M--------------------------o------------------------------------B-------E-v-
B------------------------------o-----------------------------------------B-----------------B------------------------BM------------------------?--------------------------------E-E--------B------------E-
E-----------------------------------------------------B----------------------------------------------------------------------------------------B---------------E---------------B-----------------------M-
o------B-----o--------XM---------oo----------------o-----------------------M?B--M?B------------XM-----X?X-------oBB-----------------------------B-------o-oB-?--E-----------E--------------o-BB---oo---?-
X-----ooX--------o-BBM---MM?------o?oo-B-----------o------------------------------o---------------X-----------------o--oo----MB--------oo----------------o------XM---------B?-o----------oo--------o---?-
X---oo-------------------oo------T--oo------o----oT---------o--------o-o---o-------------------------o-----B---o-----o------o----B----oT--o-------------TT-o-o------BB---E---oo---oo-oo--TT-------T----o-
X--------------------------------|--T-------------|--------oo--------Tooo-------------------------o-----------------TT-T---------------|----------------||-------------------T----TT--o--||-------|----T-
m---T---------------------------E|--|------T------|--------T---------|TT-----E------------------ET------------------||-|----------E----|---------------E||---------E---------|---E||-T---||-------|----?-
X---|-XXXXXX---XXXXXXXX-XX-XXX-XX|XX|XXXXXX|XXXXXX|XXXXXXX-|XXXXXXXXX|||XX---XXXXX-XXXXXXXXXXX-XX|XXXXXXXXX-XXXXXXXX||X|XXXXXXXXXXXXXXX|XXXXXXXXXXXXXXXX||XXXXXXXXXXXX-XXXXXX|XXXX||X|XXX||X-XXXXX|X-XXX-
