E------------------------------------------------------------------------------------------------------------------------------------------------------------------------------------------------------X-
o------------------------------------------------------------------------------------------------------------------------------------------------------------------------------------------------------|-
M------------------------------B----------------------------BB---------------------B-----------------------------------------------------------------------------------------B?B-----------------------M-
|---------------------------------------B-------------------------------------------------------------------------------------------B------------------------------------------------B-----------------?-
?--------------------------------------------B-----------------------------------------------B---------------B--------------o-B-BB----------------------------M-----o----------------------------------E-
o--------o---------------------------------------XB?M----------------------------------------------------B---------B------o-o-----------------o---------XB-----------------X---------------------------T-
B-----------------------------B?-----------------------------------?M-----------------X?B-----------------------------X-----------?B---oM??----------------------o---XM-----BBBM-------------------------
|----------?---------o--------------------------------------X---M?----------B-----------------------------B------B--------o---------------------B---------B------------oBB-------------X-----------o---v-
--------------------------------M-------------------------------o---------------------------------o----------------B----------------------------------------B------------------------------------------T-
T---------------------------------------------------------------------B-------------------------------------------------o----------------------------------------------------------------------E-------o-
B---oo--------------------o---------------------XBM--M------------o---------------------------------?X--------------B?X-----o---BM------oo----------Bo-?B-X---------B------------B---------------------T-
E----o--B?o-B?M-----------o------X?BBMX------B-o------o--------o--oo-o-------------o--BB?---o--o-------------XBBBMBo------o--Bo----------oXXM----XB---o--o---------o-----MB--M-oo---o-------o----o-B---T-
o---TT-----o------o------T---BB-------oB-------o-ooT----BB--------T--o----o-------oo---------oooo-BB----oo---------ooo--------T---------T------------T-oo---B-B---o---ooo-----TT-------------o---------?-
?---||----T--------------|--------------------o----|--------------|TT-----o--------T--------T--T--------o----------T-o----T---|---------|------------|-o-T--------o--T-o------||----T----------TT--------
m---||----|------T-------|--------------------T-T--|--------------|||---E-T--------|--------|--|--------TE----E----|T-----|---|---------|------------|-T-|-------T---|-T------||----|----------||------T-
X---X|XXXX|XXXXXX|--XXXXX|XXXXXXXXXXXX-XXX-XXX|X|XX|XX-XXXXXXXX-XX|||X-XXX|XXXXX-XX|XXXX-XXX|XX|XXXXXXXX|XXX-XXXXXX||XXXXX|--X|XXXX-XXXX|XXXXXXXXXXXX|X|X|-XXXXXX|-XX|X|XXX--X||XXX-|XXXXXXX-XX||XX----X-
