---------------------------------------------------------------------------------------------------------------------------------------------------------------------------------------------------------
-----------------------------------------------------------------------------------o---------------------------------------------------------------------------------------------M-----------------------
------------------------------------------------------------------------------------XXX------------------------------------------------------------------------------------------------------------------
---------------------------------------------------------------------------------------------------------------------------------------------------------------------------------------------------------
------------------------------------------------------------------------------------------------------------------------------------------------------------------------------------------------------X--
------------------------------------------------------------------------------------------------------------------------------------------------------------------------------------------------------X--
------------------------------------------------------------------------------------------------------------------------------------------------------------------------------------------------------X--
-----------------------------------------------------------------------------------------------------------------------------------------------------------------------------------------------------XXv-
------------------------------------------------X---------------------------------------------------------------------------------------------------------------------------------------------------XXXf-
-----------------------------------------------XX--------------------------------------------------------------------------------------------------------------------------------------------------XXXXf-
----------------------------------------------XXX----------------------------------------------------------------------------------------X--------------------------------------------------------XXXXXf-
---------------------------------------------XXXX--------------------------------B----------------------------------------------------------------------o----------------------------------------XXXXXXf-
----------------------------------T---------XXXXX-----------------------------------------------------------------------------------------------------------------------------------------------XXXXXXXf-
----------------------------------|--------XXXXXX----------------------------------------------------------------------------------------------------------------------------------------------XXXXXXXXf-
m---------------------------------|-------XXXXXXX---------------------------------------------------------------------------------------------------------------------------------------------XXXXXXXXXX-
XXXXXXXXXXXXXXXXXXXXXXXXXXXXXXXXXX|XXXXXXXXXXXXXXXXXXXXXXXXXXXXXXXXXX---XXXXXXXXXXXXXXXXXXXXXXXXXXXXXXXXXXXXXXXXXXXXXXXXXXXXXXXXXXXXXXXXXXXXXXXXXXXXXXXXXXXXXXXXXXXXXXXXXXXXXXXXXXXXXXXXXXXXXXXXXXXXXXXX-
