---------------------------------------------------------------------------------------------------------------------------------------------------------------------------------------------------------
---------------------------------------------------------------------------------------------------------------------------------------------------------------------------------------------------------
-----------oE--E-----------MB-------------E----------------------------------------------------------------------B--------------o-------------------B-------------------B--------------------------------
---------------------------oo------------------------------------------o----------E------------B------------------------------------?-----------------?--------B-------------------------M-BB------------
--------------BX-------------E-------------E-------B-----------------E-----B-----E----------------o----------------E-------------------------------o----------------------X?--X--------------------------
-------------------------o--------------E--------M-o-----------M---B---------------E-------------------EE--------------------------o---------BM-----XM-X------------------oo-----------------------------
------------E----E----------EB----E---------------------E--------E--------------------E---------M------------E----------------------------------------------------------------------------------o--------
-----E--------------B---------------------E--------------------o-----EE-E--B-----------B--------o---B----------E---------------------------------------------------------------------------o-------BM--v-
--------E-------------B---E--------B-----------------E----E-----E------------------------------E-----------------M------M-X-------------------------------------------------------------o--------------f-
---------------------------EE---B-----B-----E----------E---------------E------E------B---------------------------o-----------------------------------------B-------------------------------------------f-
-------------------------E-------------------------------M---E-----------------------------?-----------------------------------------------------MB----?--------------------------o----oo-o-------o----f-
------??----------o----oBB-----o--------------------E-X--o--------------?-------------------M-------o-oB----X---E-E-BMo----------B--o---------------BBB-X?B-----------X?------------BM?--o-------------f-
----o----------oB-o---o-o-----oo------------o-------B--oo--------B----o---------o-o-Bo---B-ooo-B-----o-----------B----o-------BB-----o---o-oo-----------o------------oo-oo--------------T-----B--oo----f-
---------------o------T-------T------T------T-----------o-------------oo--------T-------------------TT--------E---------------------T----T----------------------------o-o---------------|--------T-----f-
m-------------T-------|-------|E-E--E|------|----------T-E----------EET---------|T---T-------T--EE--||E------------------E------E---|----|-T-------E---T-------------T--T---------------|--------|-----X-
X-----XXXXXXXX|XXXXXXX|XXXXXXX|XXXXXX|XXXXXX|XXX-XXXXXX|XXXXXXXXXXX-XX|XXXXXXXXX||XXX|XXXX-XX|XXXXXX||XXXXXXXXXXXXXXXXXXXXXXXXXXXXX-|XX-X|X|XXXXXXXXXXX|XXXXXX-XXX-XX|XX|XXXXXXXXXX-XXXX|XX-XXXXX|XX--XX-
