-----------------------XXXXXX----------------------------------------------------------------------------------------------------------------------------------------------------------------------------
------------------------------------------------------------------------------------------------------------------------M----------------------------------------------------XX--------------------------
-------------------------------???-----------------------------------M-----------------------------------------------------------------------------------------------------------------------------o-----
--T---------o--------------------------------------------------------------------------------------------------------------------------------------------------------------------------------------------
--|-----------------------------------------------------?-------------B---------------------------------------------------------------------------------------o---------------------------B--------------
--|-------------------o----------o-------------------------------X----------------------------------?----------------------------------------------------------------------------------------------------
--|-------------------------------------------------------------XX---------------------------------------------------------------------------------------------------------------------------------------
--|-----------X---T----------X---------------------------------XXX--------???????---------------------------------?-------------------------B----------------------------------------------------------v-
--|-----------XX--|--------------------?----------------------XXXX------------------------------------B-----------------------------------------?---------------------o------------------------------B-f-
--|-----------XXX-|------------------------------------------XXXXX---------------------------------------------T---------------------------XXX---XXXXXXXX----------------------------------------------f-
--|----------XXXXX|--------B--------------------------------XXXXXX---------------------------------------------|--------------------------------------------------------XXX----------------------------f-
--|----------XXXXX|-----M----------------T-----------------XXXXXXX--------------------------B------------------|----------------------------------------------T-----X--------------------------X-------f-
--|----------XXXXX|X---T---------------T-|----------------XXXXXXXX-------------------------------???---------??|?---------------------------------------------|--------------------------------XX------f-
--|----------XXXXX|XX--|---------------|-|---------------XXXXXXXXX-o-----------------T-------------------------|----------------------------------------------|---BBBB-------------------------XXX-----f-
m-|----------XXXXX|XXX-|---------------|-|--------------XXXXXXXXXX-------------------|-------------------------|-E-------E---------------E-E------------------|--E-----------------------------XXXX----X-
XX|XXXXXXXXXXXXXXX|XXXX|XXXXXXXXXXXXXXX|X|XXXXXXXXXXXXXXXXXXXXXXXX------XXXXXX-------|XXXXXXXXXXXXXXXXXXXXXXXXX|XXX--XXXXXXXXXXXXXXXX---XXXXXXXXXXXX-XXXXXXXXX|XXXXXXXXXXXXXXX----XX--XX----XXXXXXXXXXXX-
