---------------------------------------------------------------------------------------------------------------------------------------------------------------------------------------------------------
---------------------------------------------------------------------------------------------------------------------------------------------------------------------------------------------------------
-------o----------o------BXB---------------------X-----------BB------------?-------------BX------BB?--------------?--------o----B?----------E------------------------------B----o-----B?-----BB----------
-----------------------B----------------------------------------------------------B-BBo-----o-------------------B?-------------------------BXM-----------------B-----------------------------------------
-----------------------------------o-----------------o--------------------------?-------------------o---------------B----------------------oo--------------------------------------o---------------------
----------------------------------------------------------BM-----------o--------------------------------------------------B---------------------------------------------------------------------BB-------
-----------------BB-----MXBBM---o----------------------------BBM?------oBX---o-------------------------------?M----------------BB?------M-------------------?B----M--oo------E-----------o--??-----------
-------MM-----XXM--------------------------------BM-----------------------?---------------B----o------o--------B--X--------------------o-----------o--B---M?---------------BB-----------o-M--o---------v-
---------?--o------------------------------------------------o-------o-----------------------------B----------------------------------------BB-----o---------------------------------------------------f-
------------o------------------------------------o----------------------------------------------B------------------B-----------------------------------------------------------------------------------f-
-----------------------BMXMB?----ooo----?-MM--------------------------o--o--------o--------------------o---------------------------BMBM-------oo-o-----------------------------------------Xo----------f-
----------oo-o-----B--------------ooB--o----BB--------BM--o---o----??ooBoo-----BBM-----------------?--M-------B-X?B--E---o-X?-X--------o---ooBooM----M----?B-------o----BB--?Bo?------B-o---oo-------M-f-
----------------B-----------------T--ooo----------B----o---oo-oBB-oo-T--To-o-BB---T---BB-------------ooT------------BB-oB-------o---oo--o-----T----B-------o---------B------o------o---o----T--------o-f-
----------T-----------------------|--o-----------------------T-----o-|--|---------|------------------o-|--------------oo-T----------oo-T---T--|-----------------oo---------------------T----|----T-----f-
m---------|-----------------------|--T--E----------E---------|----T--|--|---------|---------------E--T-|--------------T--|------T---T--|---|--|-----------------T----------------------|----|----|-----X-
X---XXXXXX|XXX-XX-XXXXXXXXXX--XXXX|XX|-XX---XXXX-XXXXXXXX-XXX|XXXX|XX|XX|X-XX-XXX-|XXXXX---XXXX-XXXXX|X|X---XXXXXXXXXX|XX|XXXXXX|-XX|--|XXX|XX|X-XXXXXXXXX-XX-XX|XX-XX-XXXXXXXXX-XXXXXX|XX-X|XXX-|XX--XX-
