---------------------------------------------------------------------------------------------------------------------------------------------------------------------------------------------------------
---------------------------------------------------------------------------------------------------------------------------------------------------------------------------------------------------------
---------------?---------------------------------B--------------------------------------------?----------M?---------?-------------------oB-----------------BB-----o----------M---------------------------
---------------------------------------------------------------------------------B-BBM-----------------?B-o----------------B--------------------------------------------?B?------------------------------
----------B------------------------------------------------------------------------------------B?BM-------------------------------------------------------------------o----------------------------------
--------MB--------------------------------------------------?--BB--------------E---------o------------------------------------X----B----------BM------B--------------------X--------------------M--------
----------o---------------B?--B----------------------------------------------X-MB------------------B?B-------B-B--------X?X-----B----------------------------?-------------------------------------B-----
--------------------?-------------------------o-B?M-------------------------o--------------o--BB------BBB---------------------------B------------------------o---------------------------------------MBv-
---------------------------------------o------------o----------M--------B-----------M-------------------------------------o------------------------BM--------------------------------------------------f-
-------B------------o----------------------------------------------------------------------------------------------------------B---------------------------------------B-------------------------------f-
-----------------M-------XX--------E--------------o----oo----o------XM----XM-----------o-----BB----------X??--B--BB---------------------M------o-o---o------E------------?-B--------o--------E-------o-f-
----M----BB-------XM---BM---------o----Bo-------?Bo-X---o-BBB----BB-o-?B-------------BooM-o----??---E?---------BB--?B--X--??-----o----------o--o-----oo-----??------?-----------o----oBBB---o?---o-----f-
-----------------------------B-B------o-o---------To-o-T--o--o-----------o-------B--o-T-----------B-o--o----B------o----B----BBBo---BBB--Too---T--oB--o-------ToBB--------o-----o--T-oo-oooo----o---T--f-
-------oo-------------------------------T---------|--o-|----------------T----------o--|-------------o--o---------------------------------|-o---|-o------o-----|-----------------T--|-----ooT----T---|--f-
m----E-T----------------------------E---|---------|--T-|----------------|---T------T--|------------T---T---------------------------------|T----|-T-----T------|-----------T-----|--|-----T-|--E-|---|--X-
XXXX-X-|XXXXX-XXXXXXXXXXXXXXXXXXXXXXX-XX|XXXXXXXXX|X-|X|XXXX-XXXX-XXXXXX|XXX|XX--XX|XX|XXXX-XXXXX--|-XX|XXXXXXXXX-XXXXXXX-XXXXXXXXXXXXX-X||---X|X|XXX-X|XXXX-X|XXXXXX--XX-|XXXXX|XX|XXXX-|X|XXXX|XX-|XXX-
