-----------------------B-o-------B-B-------------?--M-------------M-----X---------------------X-------------------------B-X--------------------B-----------B---------------o--------------------------B--
-X--E---------?-?-X-----M-------------------------B------?------------------------?-----------------B----------------B----------------------------------------------B------------------------------------
----------------o-----------------o------------?-o------------------------o--o------------------X-----o--------------------------------------------?------------------------------------M-------------o--
--B-------------------------B--o-----------------------------E------o----B-----M--------------E--------------------B----?---E-B------------------B---------------B-----------------XB---------X----------
---------B------------B---X--B---------------------------------------------------------o----------------------------B-----M--------------------------B----------X------------o--M--------------BB---B----
-X---B-----------------?-?---------------------o------------------------M---------------------------B-----------------------B----------------------------------M----B--?------B-------------X-----B------
---E----------------------------------------X------------?---BX---B------M---M------------------B--------X--B----X------------------------------------------B-o------------X-------o-o--X----X-----X-----
--------X--------------o----B---------------------B----?----------------------------B-------------------------------M---------------B----B-----------------------B-B-X----------------------------o----v-
----B----------------------------------------E----------------------------------------------------------------------------------B------------------M-----X---------------------------o-B--?------B-----f-
-?M------MX--------------------X---------?----------M-X-----------X--B--------X-----------?XB--------X-----o----B----------BB-B----X---------M-------X------?---B------X-----------B------------X------f-
-----B------o-X----B--------?MM-------X----------MB--------M---------o----X----X----B-B---o----X-E--?-------E------X-M--MX--o----M--------------------------------M-B-------------------M----?---EB-B--f-
---BX-XBB--B-----------B-XB?oo-----B-B------B-M--------X-B---M-oo-----------------M----X-?--o---X--------?--o--M----o------------o--?----XBBBo---X-----B---X-?---X-B-X---B-XBB---o---BMX---------o-----f-
-------------------o----------------o-----------B--------o----Bo--o-B-------oB------o---oo----B---------o---o-Bo----o-----------B------B-----oB----B----o----oBB--------o-----B----------oB--o----o--o-f-
-----o---------------------------------------------------------T------------T---T---T-o---------------T-----T-------T--------------------------------o--oT-----------------------T--------------TT-----f-
m----T-----------------------T-----------------T-----T---------|------------|---|---|-T---------------|-----|-----E-|------E--------E----------------T-ET|-----------------------|--T-----------||----EX-
XX-X-|XXXXXXXXXXXX-XXX--XXXXX|XXXX-XX--XX-X---X|X-X-X|XXX--XX-X|XXXX-XX-XXXX|--X|X--|X|XX-XXXXXXX-XXXX|XXX-X|XXXXXXX|-X-XXXX-XX-XXXXXX-XXX-X--XX--XXX|-X||XXX-XX-XXXXXXXXX-XXXXXX|XX|XX--XXXX-X-||XX--XX-
